年,地区名,町名,世帯,計（人）,男性（人）,女性（人）
2015,第一,大手町一丁目,226,475,230,245
2015,第一,大手町二丁目,249,458,227,231
2015,第一,大手町三丁目,121,211,112,99
2015,第一,大手町四丁目,165,289,137,152
2015,第一,大手町五丁目,125,241,123,118
2015,第一,本字出口町,33,73,35,38
2015,第一,幸町,52,121,61,60
2015,第一,本白銀町,146,272,134,138
2015,第一,白銀町,177,367,180,187
2015,第一,末広町,279,649,310,339
2015,第一,仲町,26,55,25,30
2015,第一,浅間町,98,239,109,130
2015,第一,魚町,83,186,94,92
2015,第一,通横町,7,11,5,6
2015,第一,鵰町,9,25,11,14
2015,第一,新町,3,8,5,3
2015,第一,添地町,190,316,150,166
2015,第一,西条町,196,382,184,198
2015,第一,上土町,118,239,122,117
2015,第一,本字仲町,4,9,4,5
2015,第一,本字浅間町,21,47,21,26
2015,第一,本字新町,10,25,13,12
2015,第一,本錦町,243,521,236,285
2015,第一,本丸子町,113,289,138,151
2015,第一,錦町,68,134,67,67
2015,第一,丸子町,7,10,3,7
2015,第一,八幡町,184,333,156,177
2015,第一,本町,61,107,54,53
2015,第一,下本町,43,76,41,35
2015,第一,大門町,34,79,37,42
2015,第一,真砂町,453,905,442,463
2015,第一,町方町,126,253,115,138
2015,第一,東宮後町,22,49,21,28
2015,第二,旭町,188,406,217,189
2015,第二,本字下小路町,97,195,91,104
2015,第二,本字宮町,77,182,91,91
2015,第二,市道町,328,699,309,390
2015,第二,春日町,81,150,79,71
2015,第二,蓼原町,80,189,92,97
2015,第二,蛇松町,99,202,91,111
2015,第二,本字下河原町,73,164,83,81
2015,第二,本字下河原街出口,92,179,86,93
2015,第二,下河原町,514,1088,527,561
2015,第二,本字下一丁田,124,279,130,149
2015,第二,本字前田,36,78,41,37
2015,第二,本字千本郷林,113,231,101,130
2015,第二,本字千本,62,128,58,70
2015,第二,本字千本,57,128,64,64
2015,第二,千本常盤町,61,111,52,59
2015,第二,常盤町一丁目,75,183,87,96
2015,第二,常盤町二丁目,48,103,48,55
2015,第二,常盤町三丁目,129,283,126,157
2015,第二,本松下,129,293,130,163
2015,第二,本西松下,71,161,76,85
2015,第二,本字松下七反田,75,175,84,91
2015,第二,松下町,19,42,21,21
2015,第二,千本緑町一丁目,83,171,73,98
2015,第二,千本緑町二丁目,42,74,35,39
2015,第二,千本緑町三丁目,66,115,54,61
2015,第二,千本港町,86,176,89,87
2015,第二,千本東町,79,161,79,82
2015,第二,千本西町,173,282,128,154
2015,第二,千本中町,71,173,76,97
2015,第三,我入道秋葉町,205,461,219,242
2015,第三,我入道外新田,2,5,2,3
2015,第三,下香貫石原,191,405,201,204
2015,第三,下香貫藤井原,238,501,263,238
2015,第三,下香貫矢丸,108,276,134,142
2015,第三,我入道稲荷町,138,319,163,156
2015,第三,下香貫牛臥,353,785,385,400
2015,第三,下香貫山宮前,30,73,35,38
2015,第三,我入道江川,164,388,199,189
2015,第三,我入道南条寺,243,572,269,303
2015,第三,香貫が丘,100,320,155,165
2015,第三,下香貫木ノ宮,412,1030,487,543
2015,第三,下香貫前角,81,187,88,99
2015,第三,下香貫猪沼,89,132,50,82
2015,第三,下香貫塩場,168,389,206,183
2015,第三,下香貫前原,142,307,142,165
2015,第三,下香貫浜田,201,488,242,246
2015,第三,下香貫善太夫,170,392,190,202
2015,第三,下香貫上障子,177,344,166,178
2015,第三,下香貫下障子,364,814,399,415
2015,第三,善太夫西原,6,16,9,7
2015,第三,下香貫外原,59,125,59,66
2015,第三,我入道津島町,76,159,83,76
2015,第三,下香貫島郷,391,908,455,453
2015,第三,下香貫塚田,183,414,196,218
2015,第三,下香貫大久保,286,670,306,364
2015,第三,下香貫柿原,203,405,211,194
2015,第三,下香貫清水,193,446,210,236
2015,第三,下香貫馬場,322,747,379,368
2015,第三,下香貫西村,130,247,126,121
2015,第三,下香貫上ノ原,160,350,165,185
2015,第三,下香貫給田,13,29,15,14
2015,第三,我入道浜町,106,248,112,136
2015,第三,我入道蔓陀ヶ原,35,64,32,32
2015,第三,我入道浜方,14,36,16,20
2015,第三,我入道林町,116,265,121,144
2015,第三,我入道東町,162,409,199,210
2015,第三,我入道一本松町,137,341,164,177
2015,第三,下香貫塩満,182,397,184,213
2015,第三,下香貫七面,89,220,117,103
2015,第三,下香貫林ノ下,244,570,296,274
2015,第三,下香貫汐入,262,540,285,255
2015,第三,下香貫樋ノ口,179,407,201,206
2015,第三,下香貫宮脇,406,1001,500,501
2015,第三,下香貫宮原,43,89,43,46
2015,第三,下香貫八重,437,1027,516,511
2015,第三,下香貫八重原,4,8,5,3
2015,第三,下香貫楊原,427,1008,474,534
2015,第三,下香貫六反,9,18,8,10
2015,第四,市場町,329,629,303,326
2015,第四,上香貫大洞,1,2,1,1
2015,第四,上香貫仰天峰,17,36,19,17
2015,第四,上香貫長洞,3,8,4,4
2015,第四,上香貫東坂,6,11,5,6
2015,第四,上香貫蔓陀ヶ原,1,3,2,1
2015,第四,黒瀬町,52,124,59,65
2015,第四,西島町,597,1282,617,665
2015,第四,住吉町,234,525,260,265
2015,第四,三園町,524,1132,563,569
2015,第四,玉江町,221,486,235,251
2015,第四,中瀬町,391,810,400,410
2015,第四,中原町,76,183,95,88
2015,第四,上香貫三貫地,207,531,265,266
2015,第四,上香貫東本郷町,4,6,2,4
2015,第四,上香貫二瀬川町,143,302,144,158
2015,第四,上香貫宮原町,196,425,209,216
2015,第四,上香貫獅子路,9,20,12,8
2015,第四,上香貫槙島町,101,221,106,115
2015,第四,上香貫一ノ洞,3,8,4,4
2015,第四,上香貫三ノ洞,8,13,8,5
2015,第四,上香貫九十九洞,21,52,28,24
2015,第四,上香貫坂口,4,4,0,4
2015,第四,上香貫手城山,4,5,2,3
2015,第四,山ヶ下町,15,33,18,15
2015,第四,上香貫八重,17,46,19,27
2015,第四,上香貫鉛山,3,3,1,2
2015,第四,本郷町,696,1606,731,875
2015,第四,上香貫三園町,32,64,28,36
2015,第四,南本郷町,321,742,350,392
2015,第四,上香貫南本郷町,14,31,16,15
2015,第四,御幸町,482,1063,507,556
2015,第四,吉田町,945,1886,893,993
2015,第五,泉町,343,773,372,401
2015,第五,庄栄町,389,854,390,464
2015,第五,山王台,385,801,399,402
2015,第五,三枚橋町,405,841,408,433
2015,第五,杉崎町,373,840,411,429
2015,第五,新宿町,836,1575,703,872
2015,第五,三枚橋杉崎町,1,7,4,3
2015,第五,平町,550,1003,532,471
2015,第五,高島町,694,1297,631,666
2015,第五,高沢町,916,1798,879,919
2015,第五,高島本町,358,717,365,352
2015,第五,本字下中溝,7,17,8,9
2015,第五,三枚橋荒田,19,46,25,21
2015,第五,三枚橋竹ノ岬,71,186,93,93
2015,第五,日の出町,329,699,341,358
2015,第五,三枚橋日ノ出町,72,170,77,93
2015,第五,富士見町,174,345,175,170
2015,第五,双葉町,297,571,280,291
2015,第五,本田町,505,1098,584,514
2015,第五,三芳町,96,220,96,124
2015,第五,米山町,430,1013,479,534
2015,大平,大平,1618,4026,1971,2055
2015,片浜,今沢,2199,4422,2067,2355
2015,片浜,大諏訪,1247,2836,1472,1364
2015,片浜,北今沢,338,847,430,417
2015,片浜,小諏訪,1105,2567,1268,1299
2015,片浜,西間門二丁目,32,63,29,34
2015,片浜,西間門三丁目,22,58,29,29
2015,片浜,西間門,1243,2683,1319,1364
2015,片浜,東間門一丁目,11,27,15,12
2015,片浜,東間門二丁目,86,200,95,105
2015,片浜,東間門三丁目,60,134,65,69
2015,片浜,東間門,260,577,284,293
2015,片浜,松長,1041,2408,1190,1218
2015,金岡,足高,652,1240,622,618
2015,金岡,共栄町,305,648,336,312
2015,金岡,江原町,451,995,482,513
2015,金岡,神田町,462,960,556,404
2015,金岡,北園町,83,193,91,102
2015,金岡,寿町,553,1125,554,571
2015,金岡,沢田,16,45,25,20
2015,金岡,沢田町,120,295,141,154
2015,金岡,岡一色,1379,3312,1653,1659
2015,金岡,北高島町,453,940,478,462
2015,金岡,新沢田町,648,1495,743,752
2015,金岡,駿河台,442,1030,531,499
2015,金岡,高尾台,237,553,272,281
2015,金岡,高砂町,359,838,415,423
2015,金岡,五月町,547,1129,545,584
2015,金岡,筒井町,192,421,200,221
2015,金岡,中沢田,634,1538,774,764
2015,金岡,西熊堂,440,1084,549,535
2015,金岡,西沢田,1506,3447,1756,1691
2015,金岡,沼北町一丁目,538,1138,594,544
2015,金岡,沼北町二丁目,377,896,450,446
2015,金岡,花園町,291,623,323,300
2015,金岡,東熊堂,557,1218,628,590
2015,金岡,東沢田,408,1025,524,501
2015,金岡,宮前町,199,468,230,238
2015,金岡,松沢町,296,716,357,359
2015,金岡,緑ヶ丘,139,312,167,145
2015,金岡,岡宮,2661,6165,3034,3131
2015,金岡,柳町,479,981,496,485
2015,金岡,豊町,318,774,377,397
2015,金岡,若葉町,625,1358,695,663
2015,大岡,大岡　石田ヶ丘,73,178,87,91
2015,大岡,大岡　駅前町,555,1230,601,629
2015,大岡,大岡　自由ヶ丘,511,947,420,527
2015,大岡,大岡　上石田,951,2232,1128,1104
2015,大岡,大岡　木瀬川,1507,3494,1749,1745
2015,大岡,大岡　平和郷,140,347,167,180
2015,大岡,大岡　北小林,424,970,485,485
2015,大岡,小林台,133,327,164,163
2015,大岡,大岡　下石田,1896,4565,2182,2383
2015,大岡,大岡　仙岳町,40,113,55,58
2015,大岡,大岡　太田町,161,344,163,181
2015,大岡,大岡　高田,583,1170,618,552
2015,大岡,大岡　竹ノ岬,82,185,96,89
2015,大岡,大岡　富士通ハイツ,88,164,104,60
2015,大岡,大岡　中石田,1382,3064,1556,1508
2015,大岡,大岡　富岳町,101,150,58,92
2015,大岡,大岡　富士町,81,188,89,99
2015,大岡,大岡　沼平町,294,636,300,336
2015,大岡,大岡　南小林,1366,3235,1588,1647
2015,大岡,大岡　柏葉尾,286,644,301,343
2015,大岡,大岡　日吉,1501,3422,1679,1743
2015,大岡,大岡　大岡団地,238,442,191,251
2015,静浦,江浦,293,698,323,375
2015,静浦,口野,231,547,266,281
2015,静浦,志下,1393,2958,1525,1433
2015,静浦,獅子浜,396,915,437,478
2015,静浦,多比,249,670,333,337
2015,静浦,馬込,212,489,246,243
2015,愛鷹,青野,873,2091,1062,1029
2015,愛鷹,鳥谷,613,1563,767,796
2015,愛鷹,西椎路,1354,3326,1656,1670
2015,愛鷹,東原,956,2382,1202,1180
2015,愛鷹,東椎路,2539,5924,2935,2989
2015,愛鷹,宮本　富士通寮,22,22,22,0
2015,愛鷹,宮本,170,299,167,132
2015,愛鷹,柳沢,268,676,325,351
2015,内浦,内浦小海,110,291,150,141
2015,内浦,内浦重須,232,484,215,269
2015,内浦,内浦重寺,138,330,158,172
2015,内浦,内浦長浜,85,224,112,112
2015,内浦,内浦三津,268,686,324,362
2015,西浦,西浦足保,32,89,42,47
2015,西浦,西浦江梨,79,223,103,120
2015,西浦,西浦河内,60,200,83,117
2015,西浦,西浦木負,126,364,178,186
2015,西浦,西浦久連,106,318,158,160
2015,西浦,西浦久料,25,82,40,42
2015,西浦,西浦古宇,157,259,122,137
2015,西浦,西浦立保,50,142,64,78
2015,西浦,西浦平沢,37,130,59,71
2015,原,植田,183,456,231,225
2015,原,原　新田,524,1227,637,590
2015,原,西添町,553,1393,717,676
2015,原,大塚,2272,5042,2432,2610
2015,原,原　西町,848,2132,1033,1099
2015,原,原　東町,1727,3987,1960,2027
2015,原,原町中一丁目,188,448,237,211
2015,原,原町中二丁目,239,545,280,265
2015,原,原町中三丁目,387,916,441,475
2015,原,一本松,370,770,364,406
2015,原,原　一本松,32,68,35,33
2015,原,桃里,495,1154,598,556
2015,原,原　六軒町,627,1588,774,814
2015,浮島,根古屋,791,1867,965,902
2015,浮島,井出,553,1430,683,747
2015,浮島,平沼,581,1168,603,565
2015,浮島,石川,599,1514,766,748
2015,戸田,井田,41,74,35,39
2015,戸田,戸田　入浜,166,382,200,182
2015,戸田,戸田　上野,89,207,100,107
2015,戸田,戸田　大浦,73,163,79,84
2015,戸田,戸田　大上,48,132,71,61
2015,戸田,戸田　奥南,44,95,42,53
2015,戸田,戸田　大中島,234,469,230,239
2015,戸田,戸田　鬼川,115,252,117,135
2015,戸田,戸田　小山田,78,156,83,73
2015,戸田,戸田　口南,45,89,40,49
2015,戸田,戸田　小中島,89,176,77,99
2015,戸田,戸田　一色,98,218,108,110
2015,戸田,戸田　新田,27,47,27,20
2015,戸田,戸田　大門,81,193,105,88
2015,戸田,戸田　中上,68,137,67,70
2015,戸田,戸田　平戸,59,142,71,71
2015,戸田,戸田　舟山,27,58,28,30
2015,戸田,戸田　御浜,53,100,55,45
2014,第一,大手町一丁目,230,483,231,252
2014,第一,大手町二丁目,245,456,227,229
2014,第一,大手町三丁目,124,216,109,107
2014,第一,大手町四丁目,164,299,141,158
2014,第一,大手町五丁目,136,262,137,125
2014,第一,本字出口町,35,73,36,37
2014,第一,幸町,51,125,64,61
2014,第一,本白銀町,149,274,137,137
2014,第一,白銀町,182,380,184,196
2014,第一,末広町,287,679,319,360
2014,第一,仲町,25,54,25,29
2014,第一,浅間町,98,238,109,129
2014,第一,魚町,83,187,93,94
2014,第一,通横町,6,10,4,6
2014,第一,鵰町,9,25,11,14
2014,第一,新町,3,8,5,3
2014,第一,添地町,193,323,150,173
2014,第一,西条町,199,391,183,208
2014,第一,上土町,125,254,127,127
2014,第一,本字仲町,4,10,5,5
2014,第一,本字浅間町,22,48,22,26
2014,第一,本字新町,10,26,14,12
2014,第一,本錦町,239,516,234,282
2014,第一,本丸子町,113,290,139,151
2014,第一,錦町,66,134,64,70
2014,第一,丸子町,8,10,3,7
2014,第一,八幡町,184,338,161,177
2014,第一,本町,58,104,55,49
2014,第一,下本町,44,78,39,39
2014,第一,大門町,35,84,39,45
2014,第一,真砂町,452,922,455,467
2014,第一,町方町,126,263,123,140
2014,第一,東宮後町,23,52,24,28
2014,第二,旭町,187,407,218,189
2014,第二,本字下小路町,96,195,94,101
2014,第二,本字宮町,77,185,90,95
2014,第二,市道町,330,704,315,389
2014,第二,春日町,81,155,81,74
2014,第二,蓼原町,88,212,97,115
2014,第二,蛇松町,97,205,91,114
2014,第二,本字下河原町,72,159,81,78
2014,第二,本字下河原街出口,90,183,86,97
2014,第二,下河原町,532,1132,543,589
2014,第二,本字下一丁田,126,283,130,153
2014,第二,本字前田,40,86,44,42
2014,第二,本字千本郷林,116,239,106,133
2014,第二,本字千本,66,140,66,74
2014,第二,本字千本,60,137,71,66
2014,第二,千本常盤町,64,117,53,64
2014,第二,常盤町一丁目,80,199,92,107
2014,第二,常盤町二丁目,39,87,44,43
2014,第二,常盤町三丁目,122,271,120,151
2014,第二,本松下,129,294,135,159
2014,第二,本西松下,71,158,72,86
2014,第二,本字松下七反田,78,182,87,95
2014,第二,松下町,19,44,23,21
2014,第二,千本緑町一丁目,90,189,82,107
2014,第二,千本緑町二丁目,44,79,37,42
2014,第二,千本緑町三丁目,72,125,60,65
2014,第二,千本港町,85,186,95,91
2014,第二,千本東町,86,170,85,85
2014,第二,千本西町,181,300,138,162
2014,第二,千本中町,72,179,79,100
2014,第三,我入道秋葉町,202,468,226,242
2014,第三,我入道外新田,1,4,2,2
2014,第三,下香貫石原,184,409,198,211
2014,第三,下香貫藤井原,232,493,257,236
2014,第三,下香貫矢丸,98,250,124,126
2014,第三,我入道稲荷町,139,331,168,163
2014,第三,下香貫牛臥,362,819,398,421
2014,第三,下香貫山宮前,33,80,38,42
2014,第三,我入道江川,172,413,204,209
2014,第三,我入道南条寺,236,564,268,296
2014,第三,香貫が丘,101,323,155,168
2014,第三,下香貫木ノ宮,418,1066,511,555
2014,第三,下香貫前角,86,194,91,103
2014,第三,下香貫猪沼,93,136,49,87
2014,第三,下香貫塩場,167,403,208,195
2014,第三,下香貫前原,135,301,138,163
2014,第三,下香貫浜田,203,501,253,248
2014,第三,下香貫善太夫,176,416,203,213
2014,第三,下香貫上障子,176,345,162,183
2014,第三,下香貫下障子,354,792,386,406
2014,第三,善太夫西原,5,16,8,8
2014,第三,下香貫外原,60,130,61,69
2014,第三,我入道津島町,74,159,83,76
2014,第三,下香貫島郷,397,940,460,480
2014,第三,下香貫塚田,177,411,193,218
2014,第三,下香貫大久保,278,663,304,359
2014,第三,下香貫柿原,193,401,201,200
2014,第三,下香貫清水,196,458,217,241
2014,第三,下香貫馬場,325,743,371,372
2014,第三,下香貫西村,133,266,137,129
2014,第三,下香貫上ノ原,147,336,156,180
2014,第三,下香貫給田,13,30,16,14
2014,第三,我入道浜町,104,255,120,135
2014,第三,我入道蔓陀ヶ原,36,68,35,33
2014,第三,我入道浜方,12,35,16,19
2014,第三,我入道林町,112,257,119,138
2014,第三,我入道東町,164,411,200,211
2014,第三,我入道一本松町,140,358,177,181
2014,第三,下香貫塩満,189,420,201,219
2014,第三,下香貫七面,89,223,117,106
2014,第三,下香貫林ノ下,240,577,297,280
2014,第三,下香貫汐入,270,573,297,276
2014,第三,下香貫樋ノ口,182,436,211,225
2014,第三,下香貫宮脇,414,1033,516,517
2014,第三,下香貫宮原,43,91,43,48
2014,第三,下香貫八重,442,1059,526,533
2014,第三,下香貫八重原,5,9,5,4
2014,第三,下香貫楊原,432,1024,485,539
2014,第三,下香貫六反,8,14,6,8
2014,第四,市場町,318,632,301,331
2014,第四,上香貫大洞,1,3,1,2
2014,第四,上香貫仰天峰,19,41,22,19
2014,第四,上香貫長洞,4,9,4,5
2014,第四,上香貫東坂,6,11,5,6
2014,第四,上香貫蔓陀ヶ原,1,3,2,1
2014,第四,黒瀬町,53,128,61,67
2014,第四,西島町,591,1299,621,678
2014,第四,住吉町,229,529,257,272
2014,第四,三園町,512,1133,570,563
2014,第四,玉江町,218,485,237,248
2014,第四,中瀬町,390,815,406,409
2014,第四,中原町,82,190,97,93
2014,第四,上香貫三貫地,206,533,276,257
2014,第四,上香貫東本郷町,5,7,3,4
2014,第四,上香貫二瀬川町,126,274,131,143
2014,第四,上香貫宮原町,191,417,199,218
2014,第四,上香貫獅子路,11,22,13,9
2014,第四,上香貫槙島町,107,232,110,122
2014,第四,上香貫一ノ洞,3,8,4,4
2014,第四,上香貫三ノ洞,7,12,7,5
2014,第四,上香貫九十九洞,21,56,27,29
2014,第四,上香貫坂口,4,4,0,4
2014,第四,上香貫手城山,4,5,2,3
2014,第四,山ヶ下町,15,34,19,15
2014,第四,上香貫八重,16,42,17,25
2014,第四,上香貫鉛山,3,3,1,2
2014,第四,本郷町,694,1615,748,867
2014,第四,上香貫三園町,33,71,31,40
2014,第四,南本郷町,321,732,347,385
2014,第四,上香貫南本郷町,14,32,16,16
2014,第四,御幸町,470,1065,508,557
2014,第四,吉田町,940,1903,900,1003
2014,第五,泉町,340,783,379,404
2014,第五,庄栄町,402,895,417,478
2014,第五,山王台,373,788,391,397
2014,第五,三枚橋町,405,848,410,438
2014,第五,杉崎町,369,823,399,424
2014,第五,新宿町,837,1606,723,883
2014,第五,三枚橋杉崎町,1,7,4,3
2014,第五,平町,526,972,508,464
2014,第五,高島町,697,1307,637,670
2014,第五,高沢町,916,1793,883,910
2014,第五,高島本町,368,741,378,363
2014,第五,本字下中溝,7,18,10,8
2014,第五,三枚橋荒田,19,52,29,23
2014,第五,三枚橋竹ノ岬,73,191,95,96
2014,第五,日の出町,329,730,356,374
2014,第五,三枚橋日ノ出町,72,168,79,89
2014,第五,富士見町,181,361,183,178
2014,第五,双葉町,305,585,281,304
2014,第五,本田町,507,1113,587,526
2014,第五,三芳町,94,224,94,130
2014,第五,米山町,426,1019,481,538
2014,大平,大平,1600,4058,1971,2087
2014,片浜,今沢,2235,4521,2109,2412
2014,片浜,大諏訪,1223,2856,1478,1378
2014,片浜,北今沢,329,844,425,419
2014,片浜,小諏訪,1080,2552,1254,1298
2014,片浜,西間門二丁目,34,64,31,33
2014,片浜,西間門三丁目,23,58,28,30
2014,片浜,西間門,1252,2742,1343,1399
2014,片浜,東間門一丁目,10,23,13,10
2014,片浜,東間門二丁目,86,211,99,112
2014,片浜,東間門三丁目,61,134,64,70
2014,片浜,東間門,261,596,294,302
2014,片浜,松長,1020,2372,1173,1199
2014,金岡,足高,645,1253,617,636
2014,金岡,共栄町,271,587,301,286
2014,金岡,江原町,445,1001,478,523
2014,金岡,神田町,442,937,528,409
2014,金岡,北園町,82,197,93,104
2014,金岡,寿町,539,1115,560,555
2014,金岡,沢田,15,45,26,19
2014,金岡,沢田町,109,271,132,139
2014,金岡,岡一色,1378,3328,1663,1665
2014,金岡,北高島町,458,952,482,470
2014,金岡,新沢田町,629,1468,738,730
2014,金岡,駿河台,439,1027,524,503
2014,金岡,高尾台,235,551,274,277
2014,金岡,高砂町,361,839,412,427
2014,金岡,五月町,533,1125,546,579
2014,金岡,筒井町,187,414,195,219
2014,金岡,中沢田,622,1538,777,761
2014,金岡,西熊堂,433,1086,541,545
2014,金岡,西沢田,1492,3458,1751,1707
2014,金岡,沼北町一丁目,542,1141,601,540
2014,金岡,沼北町二丁目,382,917,466,451
2014,金岡,花園町,286,611,314,297
2014,金岡,東熊堂,555,1226,641,585
2014,金岡,東沢田,399,1001,513,488
2014,金岡,宮前町,208,490,239,251
2014,金岡,松沢町,300,743,373,370
2014,金岡,緑ヶ丘,129,295,154,141
2014,金岡,岡宮,2607,6101,3001,3100
2014,金岡,柳町,497,1016,521,495
2014,金岡,豊町,316,784,379,405
2014,金岡,若葉町,645,1426,723,703
2014,大岡,大岡　石田ヶ丘,71,174,84,90
2014,大岡,大岡　駅前町,557,1233,603,630
2014,大岡,大岡　自由ヶ丘,509,971,437,534
2014,大岡,大岡　上石田,944,2232,1120,1112
2014,大岡,大岡　木瀬川,1475,3467,1735,1732
2014,大岡,大岡　平和郷,134,348,169,179
2014,大岡,大岡　北小林,440,983,493,490
2014,大岡,小林台,134,331,170,161
2014,大岡,大岡　下石田,1873,4594,2211,2383
2014,大岡,大岡　仙岳町,48,132,67,65
2014,大岡,大岡　太田町,170,361,173,188
2014,大岡,大岡　高田,553,1124,585,539
2014,大岡,大岡　竹ノ岬,74,163,83,80
2014,大岡,大岡　富士通ハイツ,97,187,114,73
2014,大岡,大岡　中石田,1341,3029,1526,1503
2014,大岡,大岡　富岳町,105,160,65,95
2014,大岡,大岡　富士町,84,193,92,101
2014,大岡,大岡　沼平町,281,615,293,322
2014,大岡,大岡　南小林,1348,3195,1575,1620
2014,大岡,大岡　柏葉尾,286,630,287,343
2014,大岡,大岡　日吉,1516,3502,1716,1786
2014,大岡,大岡　大岡団地,233,424,185,239
2014,静浦,江浦,298,723,339,384
2014,静浦,口野,233,583,283,300
2014,静浦,志下,1429,3064,1576,1488
2014,静浦,獅子浜,403,942,457,485
2014,静浦,多比,253,686,340,346
2014,静浦,馬込,217,504,256,248
2014,愛鷹,青野,861,2093,1065,1028
2014,愛鷹,鳥谷,619,1609,797,812
2014,愛鷹,西椎路,1342,3322,1667,1655
2014,愛鷹,東原,957,2428,1227,1201
2014,愛鷹,東椎路,2541,6004,2981,3023
2014,愛鷹,宮本　富士通寮,16,16,16,0
2014,愛鷹,宮本,177,308,175,133
2014,愛鷹,柳沢,259,662,314,348
2014,内浦,内浦小海,108,297,153,144
2014,内浦,内浦重須,232,498,218,280
2014,内浦,内浦重寺,144,337,159,178
2014,内浦,内浦長浜,85,229,114,115
2014,内浦,内浦三津,270,702,326,376
2014,西浦,西浦足保,30,90,40,50
2014,西浦,西浦江梨,79,227,106,121
2014,西浦,西浦河内,60,205,85,120
2014,西浦,西浦木負,127,376,185,191
2014,西浦,西浦久連,109,334,167,167
2014,西浦,西浦久料,26,86,41,45
2014,西浦,西浦古宇,153,255,112,143
2014,西浦,西浦立保,50,147,67,80
2014,西浦,西浦平沢,38,130,60,70
2014,原,植田,181,454,226,228
2014,原,原　新田,518,1234,639,595
2014,原,西添町,568,1409,729,680
2014,原,大塚,2265,5156,2512,2644
2014,原,原　西町,839,2113,1022,1091
2014,原,原　東町,1702,4027,1983,2044
2014,原,原町中一丁目,176,434,230,204
2014,原,原町中二丁目,220,510,263,247
2014,原,原町中三丁目,388,967,469,498
2014,原,一本松,364,791,370,421
2014,原,原　一本松,32,66,35,31
2014,原,桃里,494,1174,608,566
2014,原,原　六軒町,634,1642,799,843
2014,浮島,根古屋,783,1879,965,914
2014,浮島,井出,560,1457,697,760
2014,浮島,平沼,589,1201,624,577
2014,浮島,石川,609,1535,780,755
2014,戸田,井田,40,75,37,38
2014,戸田,戸田　入浜,168,401,211,190
2014,戸田,戸田　上野,91,211,99,112
2014,戸田,戸田　大浦,76,174,85,89
2014,戸田,戸田　大上,50,138,71,67
2014,戸田,戸田　奥南,44,98,43,55
2014,戸田,戸田　大中島,228,473,233,240
2014,戸田,戸田　鬼川,117,264,120,144
2014,戸田,戸田　小山田,75,151,81,70
2014,戸田,戸田　口南,44,93,40,53
2014,戸田,戸田　小中島,95,187,82,105
2014,戸田,戸田　一色,97,217,109,108
2014,戸田,戸田　新田,31,53,30,23
2014,戸田,戸田　大門,81,190,103,87
2014,戸田,戸田　中上,69,137,67,70
2014,戸田,戸田　平戸,61,154,78,76
2014,戸田,戸田　舟山,28,61,29,32
2014,戸田,戸田　御浜,63,114,59,55
2013,第一,大手町一丁目,230,476,224,252
2013,第一,大手町二丁目,252,468,236,232
2013,第一,大手町三丁目,128,234,121,113
2013,第一,大手町四丁目,152,285,132,153
2013,第一,大手町五丁目,136,270,141,129
2013,第一,本字出口町,37,79,38,41
2013,第一,幸町,54,129,68,61
2013,第一,本白銀町,150,282,137,145
2013,第一,白銀町,170,359,177,182
2013,第一,末広町,297,708,335,373
2013,第一,仲町,27,55,25,30
2013,第一,浅間町,97,227,105,122
2013,第一,魚町,87,199,95,104
2013,第一,通横町,6,11,4,7
2013,第一,鵰町,9,26,12,14
2013,第一,新町,3,8,5,3
2013,第一,添地町,183,303,138,165
2013,第一,西条町,207,414,192,222
2013,第一,上土町,119,249,126,123
2013,第一,本字仲町,4,11,5,6
2013,第一,本字浅間町,24,53,23,30
2013,第一,本字新町,9,28,15,13
2013,第一,本錦町,240,497,231,266
2013,第一,本丸子町,110,286,138,148
2013,第一,錦町,66,131,65,66
2013,第一,丸子町,8,12,5,7
2013,第一,八幡町,176,341,163,178
2013,第一,本町,57,106,55,51
2013,第一,下本町,41,77,36,41
2013,第一,大門町,35,88,40,48
2013,第一,真砂町,432,893,432,461
2013,第一,町方町,129,267,125,142
2013,第一,東宮後町,24,54,25,29
2013,第二,旭町,189,415,222,193
2013,第二,本字下小路町,95,195,96,99
2013,第二,本字宮町,80,196,96,100
2013,第二,市道町,338,728,330,398
2013,第二,春日町,85,166,87,79
2013,第二,蓼原町,87,203,96,107
2013,第二,蛇松町,103,224,106,118
2013,第二,本字下河原町,74,170,87,83
2013,第二,本字下河原街出口,85,182,85,97
2013,第二,下河原町,528,1156,556,600
2013,第二,本字下一丁田,135,297,135,162
2013,第二,本字前田,40,85,46,39
2013,第二,本字千本郷林,116,240,109,131
2013,第二,本字千本,68,147,71,76
2013,第二,本字千本,67,156,83,73
2013,第二,千本常盤町,63,120,55,65
2013,第二,常盤町一丁目,84,200,91,109
2013,第二,常盤町二丁目,43,93,46,47
2013,第二,常盤町三丁目,122,282,130,152
2013,第二,本松下,130,304,138,166
2013,第二,本西松下,70,166,79,87
2013,第二,本字松下七反田,76,177,83,94
2013,第二,松下町,19,43,23,20
2013,第二,千本緑町一丁目,93,195,84,111
2013,第二,千本緑町二丁目,44,79,37,42
2013,第二,千本緑町三丁目,71,129,64,65
2013,第二,千本港町,93,203,106,97
2013,第二,千本東町,91,179,91,88
2013,第二,千本西町,181,308,142,166
2013,第二,千本中町,76,185,85,100
2013,第三,我入道秋葉町,206,483,234,249
2013,第三,我入道外新田,1,4,2,2
2013,第三,下香貫石原,179,414,199,215
2013,第三,下香貫藤井原,243,524,273,251
2013,第三,下香貫矢丸,102,250,124,126
2013,第三,我入道稲荷町,137,340,171,169
2013,第三,下香貫牛臥,355,822,397,425
2013,第三,下香貫山宮前,33,80,39,41
2013,第三,我入道江川,174,428,212,216
2013,第三,我入道南条寺,245,586,289,297
2013,第三,香貫が丘,100,324,155,169
2013,第三,下香貫木ノ宮,419,1082,520,562
2013,第三,下香貫前角,79,170,81,89
2013,第三,下香貫猪沼,94,137,48,89
2013,第三,下香貫塩場,167,390,200,190
2013,第三,下香貫前原,132,299,138,161
2013,第三,下香貫浜田,204,518,262,256
2013,第三,下香貫善太夫,178,428,203,225
2013,第三,下香貫上障子,180,355,166,189
2013,第三,下香貫下障子,349,798,390,408
2013,第三,善太夫西原,5,16,8,8
2013,第三,下香貫外原,63,138,66,72
2013,第三,我入道津島町,75,172,84,88
2013,第三,下香貫島郷,391,937,456,481
2013,第三,下香貫塚田,185,432,209,223
2013,第三,下香貫大久保,274,668,305,363
2013,第三,下香貫柿原,196,430,214,216
2013,第三,下香貫清水,190,445,215,230
2013,第三,下香貫馬場,334,766,381,385
2013,第三,下香貫西村,131,274,143,131
2013,第三,下香貫上ノ原,149,340,158,182
2013,第三,下香貫給田,13,30,16,14
2013,第三,我入道浜町,104,258,121,137
2013,第三,我入道蔓陀ヶ原,35,68,35,33
2013,第三,我入道浜方,12,35,17,18
2013,第三,我入道林町,112,265,122,143
2013,第三,我入道東町,163,423,205,218
2013,第三,我入道一本松町,144,371,180,191
2013,第三,下香貫塩満,191,437,206,231
2013,第三,下香貫七面,86,225,119,106
2013,第三,下香貫林ノ下,241,598,309,289
2013,第三,下香貫汐入,263,559,292,267
2013,第三,下香貫樋ノ口,187,443,218,225
2013,第三,下香貫宮脇,414,1029,510,519
2013,第三,下香貫宮原,45,95,44,51
2013,第三,下香貫八重,442,1062,531,531
2013,第三,下香貫八重原,5,9,5,4
2013,第三,下香貫楊原,448,1072,502,570
2013,第三,下香貫六反,8,14,6,8
2013,第四,市場町,323,661,309,352
2013,第四,上香貫大洞,1,3,1,2
2013,第四,上香貫仰天峰,18,40,22,18
2013,第四,上香貫長洞,4,9,4,5
2013,第四,上香貫東坂,6,11,5,6
2013,第四,上香貫蔓陀ヶ原,1,3,2,1
2013,第四,黒瀬町,53,132,62,70
2013,第四,西島町,602,1350,647,703
2013,第四,住吉町,226,534,258,276
2013,第四,三園町,503,1154,575,579
2013,第四,玉江町,227,495,248,247
2013,第四,中瀬町,399,841,415,426
2013,第四,中原町,77,185,94,91
2013,第四,上香貫三貫地,218,575,299,276
2013,第四,上香貫東本郷町,6,9,5,4
2013,第四,上香貫二瀬川町,132,290,141,149
2013,第四,上香貫宮原町,195,432,204,228
2013,第四,上香貫獅子路,10,22,13,9
2013,第四,上香貫槙島町,109,242,114,128
2013,第四,上香貫一ノ洞,3,8,4,4
2013,第四,上香貫三ノ洞,6,11,6,5
2013,第四,上香貫九十九洞,21,58,27,31
2013,第四,上香貫坂口,4,6,2,4
2013,第四,上香貫手城山,4,5,2,3
2013,第四,山ヶ下町,15,35,19,16
2013,第四,上香貫八重,21,50,21,29
2013,第四,上香貫鉛山,4,4,2,2
2013,第四,本郷町,694,1612,747,865
2013,第四,上香貫三園町,29,61,28,33
2013,第四,南本郷町,314,719,343,376
2013,第四,上香貫南本郷町,12,29,14,15
2013,第四,御幸町,459,1050,495,555
2013,第四,吉田町,945,1910,896,1014
2013,第五,泉町,342,810,393,417
2013,第五,庄栄町,398,909,421,488
2013,第五,山王台,370,780,383,397
2013,第五,三枚橋町,411,861,425,436
2013,第五,杉崎町,381,851,415,436
2013,第五,新宿町,821,1612,725,887
2013,第五,三枚橋杉崎町,1,7,4,3
2013,第五,平町,520,966,506,460
2013,第五,高島町,700,1336,649,687
2013,第五,高沢町,928,1846,911,935
2013,第五,高島本町,381,759,391,368
2013,第五,本字下中溝,8,19,10,9
2013,第五,三枚橋荒田,19,55,32,23
2013,第五,三枚橋竹ノ岬,70,184,93,91
2013,第五,日の出町,321,713,348,365
2013,第五,三枚橋日ノ出町,71,173,82,91
2013,第五,富士見町,186,364,188,176
2013,第五,双葉町,282,565,268,297
2013,第五,本田町,507,1099,567,532
2013,第五,三芳町,92,215,87,128
2013,第五,米山町,424,1031,480,551
2013,大平,大平,1595,4127,2002,2125
2013,片浜,今沢,2255,4619,2161,2458
2013,片浜,大諏訪,1258,2947,1529,1418
2013,片浜,北今沢,330,854,437,417
2013,片浜,小諏訪,1085,2598,1277,1321
2013,片浜,西間門二丁目,35,64,29,35
2013,片浜,西間門三丁目,22,57,27,30
2013,片浜,西間門,1253,2786,1364,1422
2013,片浜,東間門一丁目,9,20,10,10
2013,片浜,東間門二丁目,88,220,101,119
2013,片浜,東間門三丁目,61,135,66,69
2013,片浜,東間門,262,595,297,298
2013,片浜,松長,996,2396,1176,1220
2013,金岡,足高,643,1239,616,623
2013,金岡,共栄町,279,599,309,290
2013,金岡,江原町,453,994,490,504
2013,金岡,神田町,418,915,502,413
2013,金岡,北園町,74,183,87,96
2013,金岡,寿町,564,1183,602,581
2013,金岡,沢田,14,44,25,19
2013,金岡,沢田町,111,294,140,154
2013,金岡,岡一色,1375,3371,1689,1682
2013,金岡,北高島町,465,953,489,464
2013,金岡,新沢田町,629,1488,752,736
2013,金岡,駿河台,432,1020,519,501
2013,金岡,高尾台,234,568,282,286
2013,金岡,高砂町,345,837,418,419
2013,金岡,五月町,545,1144,564,580
2013,金岡,筒井町,184,408,191,217
2013,金岡,中沢田,635,1575,799,776
2013,金岡,西熊堂,434,1106,547,559
2013,金岡,西沢田,1479,3448,1743,1705
2013,金岡,沼北町一丁目,532,1139,597,542
2013,金岡,沼北町二丁目,370,911,459,452
2013,金岡,花園町,298,628,327,301
2013,金岡,東熊堂,536,1215,630,585
2013,金岡,東沢田,409,1025,522,503
2013,金岡,宮前町,199,491,239,252
2013,金岡,松沢町,296,737,371,366
2013,金岡,緑ヶ丘,132,286,153,133
2013,金岡,岡宮,2538,5987,2948,3039
2013,金岡,柳町,493,1021,515,506
2013,金岡,豊町,314,794,386,408
2013,金岡,若葉町,639,1420,721,699
2013,大岡,大岡石田ヶ丘,73,178,86,92
2013,大岡,大岡駅前町,554,1259,618,641
2013,大岡,大岡自由ヶ丘,508,984,442,542
2013,大岡,大岡上石田,949,2230,1110,1120
2013,大岡,大岡木瀬川,1458,3388,1700,1688
2013,大岡,大岡平和郷,132,346,164,182
2013,大岡,大岡北小林,425,966,485,481
2013,大岡,小林台,126,320,165,155
2013,大岡,大岡下石田,1879,4668,2257,2411
2013,大岡,大岡仙岳町,60,169,83,86
2013,大岡,大岡太田町,147,317,155,162
2013,大岡,大岡高田,575,1175,618,557
2013,大岡,大岡竹ノ岬,76,176,92,84
2013,大岡,大岡富士通ハイツ,100,194,122,72
2013,大岡,大岡中石田,1331,2997,1510,1487
2013,大岡,大岡富岳町,97,150,62,88
2013,大岡,大岡富士町,93,206,104,102
2013,大岡,大岡沼平町,279,633,307,326
2013,大岡,大岡南小林,1298,3058,1523,1535
2013,大岡,大岡柏葉尾,282,612,278,334
2013,大岡,大岡日吉,1534,3599,1777,1822
2013,大岡,大岡大岡団地,235,430,185,245
2013,静浦,江浦,301,735,348,387
2013,静浦,口野,230,593,282,311
2013,静浦,志下,1449,3144,1631,1513
2013,静浦,獅子浜,405,963,468,495
2013,静浦,多比,252,699,343,356
2013,静浦,馬込,220,512,259,253
2013,愛鷹,青野,860,2134,1087,1047
2013,愛鷹,鳥谷,607,1605,805,800
2013,愛鷹,西椎路,1330,3336,1670,1666
2013,愛鷹,東原,942,2395,1202,1193
2013,愛鷹,東椎路,2538,6070,3004,3066
2013,愛鷹,宮本富士通寮,13,13,13,0
2013,愛鷹,宮本,176,306,175,131
2013,愛鷹,柳沢,253,671,316,355
2013,内浦,内浦小海,110,306,157,149
2013,内浦,内浦重須,237,515,228,287
2013,内浦,内浦重寺,145,356,168,188
2013,内浦,内浦長浜,85,237,121,116
2013,内浦,内浦三津,278,741,348,393
2013,西浦,西浦足保,32,94,43,51
2013,西浦,西浦江梨,79,224,105,119
2013,西浦,西浦河内,59,200,84,116
2013,西浦,西浦木負,125,391,194,197
2013,西浦,西浦久連,108,347,172,175
2013,西浦,西浦久料,24,91,42,49
2013,西浦,西浦古宇,153,266,114,152
2013,西浦,西浦立保,50,154,71,83
2013,西浦,西浦平沢,38,133,60,73
2013,原,植田,184,471,234,237
2013,原,原新田,522,1252,646,606
2013,原,西添町,552,1367,714,653
2013,原,大塚,2267,5227,2558,2669
2013,原,原西町,825,2100,1026,1074
2013,原,原東町,1698,4071,1997,2074
2013,原,原町中一丁目,174,423,218,205
2013,原,原町中二丁目,213,507,265,242
2013,原,原町中三丁目,402,1003,483,520
2013,原,一本松,370,800,376,424
2013,原,原一本松,34,67,34,33
2013,原,桃里,492,1179,610,569
2013,原,原六軒町,636,1676,820,856
2013,浮島,根古屋,771,1911,967,944
2013,浮島,井出,551,1460,696,764
2013,浮島,平沼,586,1210,635,575
2013,浮島,石川,607,1553,785,768
2013,戸田,井田,40,83,39,44
2013,戸田,戸田入浜,169,403,213,190
2013,戸田,戸田上野,90,216,103,113
2013,戸田,戸田大浦,76,181,86,95
2013,戸田,戸田大上,49,138,71,67
2013,戸田,戸田奥南,46,103,44,59
2013,戸田,戸田大中島,229,490,238,252
2013,戸田,戸田鬼川,120,275,129,146
2013,戸田,戸田小山田,73,155,80,75
2013,戸田,戸田口南,45,97,43,54
2013,戸田,戸田小中島,95,192,84,108
2013,戸田,戸田一色,101,231,115,116
2013,戸田,戸田新田,32,57,31,26
2013,戸田,戸田大門,81,195,106,89
2013,戸田,戸田中上,68,142,72,70
2013,戸田,戸田平戸,60,157,78,79
2013,戸田,戸田舟山,28,62,30,32
2013,戸田,戸田御浜,61,113,56,57
2012,第一,大手町一丁目,221,464,225,239
2012,第一,大手町二丁目,221,402,211,191
2012,第一,大手町三丁目,125,230,121,109
2012,第一,大手町四丁目,143,283,128,155
2012,第一,大手町五丁目,123,255,126,129
2012,第一,本字出口町,38,85,42,43
2012,第一,幸町,48,115,59,56
2012,第一,本白銀町,137,260,125,135
2012,第一,白銀町,146,312,159,153
2012,第一,末広町,295,719,345,374
2012,第一,仲町,26,58,25,33
2012,第一,浅間町,87,195,91,104
2012,第一,魚町,82,186,91,95
2012,第一,通横町,6,11,4,7
2012,第一,鵰町,10,27,13,14
2012,第一,新町,4,10,6,4
2012,第一,添地町,180,308,141,167
2012,第一,西条町,206,414,197,217
2012,第一,上土町,118,254,129,125
2012,第一,本字仲町,4,11,5,6
2012,第一,本字浅間町,24,50,23,27
2012,第一,本字新町,10,32,16,16
2012,第一,本錦町,235,483,223,260
2012,第一,本丸子町,111,283,138,145
2012,第一,錦町,68,143,67,76
2012,第一,丸子町,8,11,4,7
2012,第一,八幡町,165,319,155,164
2012,第一,本町,56,99,50,49
2012,第一,下本町,39,78,37,41
2012,第一,大門町,34,89,41,48
2012,第一,真砂町,440,921,442,479
2012,第一,町方町,128,257,128,129
2012,第一,東宮後町,23,53,24,29
2012,第二,旭町,191,428,228,200
2012,第二,本字下小路町,94,197,97,100
2012,第二,本字宮町,82,198,100,98
2012,第二,市道町,335,733,336,397
2012,第二,春日町,69,158,83,75
2012,第二,蓼原町,66,190,94,96
2012,第二,蛇松町,87,212,101,111
2012,第二,本字下河原町,77,186,92,94
2012,第二,本字下河原街出口,90,189,92,97
2012,第二,下河原町,511,1147,554,593
2012,第二,本字下一丁田,147,322,145,177
2012,第二,本字前田,41,88,47,41
2012,第二,本字千本郷林,119,248,114,134
2012,第二,本字千本,72,157,73,84
2012,第二,本字千本,74,167,89,78
2012,第二,千本常盤町,61,123,55,68
2012,第二,常盤町一丁目,85,204,97,107
2012,第二,常盤町二丁目,41,97,47,50
2012,第二,常盤町三丁目,120,284,130,154
2012,第二,本松下,133,310,142,168
2012,第二,本西松下,69,162,78,84
2012,第二,本字松下七反田,80,189,91,98
2012,第二,松下町,18,44,24,20
2012,第二,千本緑町一丁目,92,193,83,110
2012,第二,千本緑町二丁目,40,78,34,44
2012,第二,千本緑町三丁目,67,129,64,65
2012,第二,千本港町,82,189,100,89
2012,第二,千本東町,83,170,86,84
2012,第二,千本西町,106,239,120,119
2012,第二,千本中町,61,171,78,93
2012,第三,我入道秋葉町,194,479,236,243
2012,第三,我入道外新田,1,4,2,2
2012,第三,下香貫石原,157,383,186,197
2012,第三,下香貫藤井原,235,521,270,251
2012,第三,下香貫矢丸,95,239,118,121
2012,第三,我入道稲荷町,141,353,175,178
2012,第三,下香貫牛臥,349,834,407,427
2012,第三,下香貫山宮前,32,81,39,42
2012,第三,我入道江川,172,435,216,219
2012,第三,我入道南条寺,236,574,286,288
2012,第三,香貫が丘,101,334,160,174
2012,第三,下香貫木ノ宮,414,1075,519,556
2012,第三,下香貫前角,79,165,79,86
2012,第三,下香貫猪沼,92,135,49,86
2012,第三,下香貫塩場,173,405,212,193
2012,第三,下香貫前原,134,308,144,164
2012,第三,下香貫浜田,207,523,270,253
2012,第三,下香貫善太夫,180,436,214,222
2012,第三,下香貫上障子,179,354,162,192
2012,第三,下香貫下障子,360,837,411,426
2012,第三,善太夫西原,5,15,8,7
2012,第三,下香貫外原,62,146,70,76
2012,第三,我入道津島町,74,176,88,88
2012,第三,下香貫島郷,381,941,457,484
2012,第三,下香貫塚田,189,443,214,229
2012,第三,下香貫大久保,270,675,305,370
2012,第三,下香貫柿原,190,444,215,229
2012,第三,下香貫清水,194,456,224,232
2012,第三,下香貫馬場,348,796,388,408
2012,第三,下香貫西村,135,278,142,136
2012,第三,下香貫上ノ原,146,342,160,182
2012,第三,下香貫給田,12,29,14,15
2012,第三,我入道浜町,101,258,121,137
2012,第三,我入道蔓陀ヶ原,36,71,36,35
2012,第三,我入道浜方,11,31,14,17
2012,第三,我入道林町,111,268,124,144
2012,第三,我入道東町,164,441,215,226
2012,第三,我入道一本松町,140,365,175,190
2012,第三,下香貫塩満,191,435,203,232
2012,第三,下香貫七面,87,228,120,108
2012,第三,下香貫林ノ下,240,619,316,303
2012,第三,下香貫汐入,244,537,277,260
2012,第三,下香貫樋ノ口,180,423,206,217
2012,第三,下香貫宮脇,415,1031,517,514
2012,第三,下香貫宮原,46,97,46,51
2012,第三,下香貫八重,445,1086,538,548
2012,第三,下香貫八重原,5,10,6,4
2012,第三,下香貫楊原,460,1103,515,588
2012,第三,下香貫六反,8,16,7,9
2012,第四,市場町,331,675,324,351
2012,第四,上香貫大洞,1,3,1,2
2012,第四,上香貫仰天峰,17,38,20,18
2012,第四,上香貫長洞,3,7,3,4
2012,第四,上香貫東坂,6,11,5,6
2012,第四,上香貫蔓陀ヶ原,2,4,2,2
2012,第四,黒瀬町,55,131,61,70
2012,第四,西島町,606,1383,664,719
2012,第四,住吉町,233,554,274,280
2012,第四,三園町,504,1173,583,590
2012,第四,玉江町,218,496,254,242
2012,第四,中瀬町,374,784,381,403
2012,第四,中原町,79,182,93,89
2012,第四,上香貫三貫地,208,572,291,281
2012,第四,上香貫東本郷町,8,11,6,5
2012,第四,上香貫二瀬川町,136,304,154,150
2012,第四,上香貫宮原町,203,454,214,240
2012,第四,上香貫獅子路,10,23,13,10
2012,第四,上香貫槙島町,107,240,114,126
2012,第四,上香貫一ノ洞,3,8,4,4
2012,第四,上香貫三ノ洞,6,12,6,6
2012,第四,上香貫九十九洞,22,57,27,30
2012,第四,上香貫坂口,4,6,2,4
2012,第四,上香貫手城山,4,5,2,3
2012,第四,山ヶ下町,15,36,20,16
2012,第四,上香貫八重,21,51,22,29
2012,第四,上香貫鉛山,4,4,2,2
2012,第四,本郷町,700,1638,755,883
2012,第四,上香貫三園町,25,60,29,31
2012,第四,南本郷町,324,747,358,389
2012,第四,上香貫南本郷町,13,31,15,16
2012,第四,御幸町,464,1052,495,557
2012,第四,吉田町,957,1958,927,1031
2012,第五,泉町,337,792,386,406
2012,第五,庄栄町,393,892,412,480
2012,第五,山王台,378,821,397,424
2012,第五,三枚橋町,400,855,433,422
2012,第五,杉崎町,359,823,396,427
2012,第五,新宿町,802,1570,727,843
2012,第五,三枚橋杉崎町,1,7,4,3
2012,第五,平町,502,957,495,462
2012,第五,高島町,645,1241,615,626
2012,第五,高沢町,871,1759,892,867
2012,第五,高島本町,360,725,374,351
2012,第五,本字下中溝,7,16,8,8
2012,第五,三枚橋荒田,22,60,35,25
2012,第五,三枚橋竹ノ岬,66,183,93,90
2012,第五,日の出町,317,716,345,371
2012,第五,三枚橋日ノ出町,77,181,84,97
2012,第五,富士見町,182,365,185,180
2012,第五,双葉町,262,519,253,266
2012,第五,本田町,497,1094,563,531
2012,第五,三芳町,89,217,89,128
2012,第五,米山町,425,1022,476,546
2012,大平,大平,1606,4184,2028,2156
2012,片浜,今沢,2223,4577,2159,2418
2012,片浜,大諏訪,1247,2955,1526,1429
2012,片浜,北今沢,323,869,443,426
2012,片浜,小諏訪,1086,2632,1283,1349
2012,片浜,西間門一丁目,0,0,0,0
2012,片浜,西間門二丁目,30,59,26,33
2012,片浜,西間門三丁目,22,56,27,29
2012,片浜,西間門,1265,2846,1404,1442
2012,片浜,東間門一丁目,9,21,11,10
2012,片浜,東間門二丁目,87,215,102,113
2012,片浜,東間門三丁目,63,142,66,76
2012,片浜,東間門,260,608,303,305
2012,片浜,松長,999,2431,1205,1226
2012,金岡,足高,579,1171,597,574
2012,金岡,共栄町,271,576,307,269
2012,金岡,江原町,439,1005,501,504
2012,金岡,神田町,415,911,497,414
2012,金岡,北園町,75,190,94,96
2012,金岡,寿町,574,1203,625,578
2012,金岡,沢田,14,44,25,19
2012,金岡,沢田町,115,297,147,150
2012,金岡,岡一色,1330,3316,1674,1642
2012,金岡,北高島町,456,938,480,458
2012,金岡,新沢田町,626,1466,743,723
2012,金岡,駿河台,413,1009,514,495
2012,金岡,高尾台,236,573,294,279
2012,金岡,高砂町,335,835,413,422
2012,金岡,五月町,537,1125,557,568
2012,金岡,筒井町,175,383,177,206
2012,金岡,中沢田,635,1586,807,779
2012,金岡,西熊堂,434,1121,563,558
2012,金岡,西沢田,1454,3410,1729,1681
2012,金岡,沼北町一丁目,562,1183,636,547
2012,金岡,沼北町二丁目,372,909,464,445
2012,金岡,花園町,288,620,323,297
2012,金岡,東熊堂,528,1203,627,576
2012,金岡,東沢田,411,1021,530,491
2012,金岡,宮前町,199,492,237,255
2012,金岡,松沢町,297,720,355,365
2012,金岡,緑ヶ丘,124,264,143,121
2012,金岡,岡宮,2391,5722,2845,2877
2012,金岡,柳町,482,1004,519,485
2012,金岡,豊町,321,826,409,417
2012,金岡,若葉町,628,1389,711,678
2012,大岡,大岡　石田ヶ丘,72,180,87,93
2012,大岡,大岡　駅前町,540,1237,603,634
2012,大岡,大岡,0,0,0,0
2012,大岡,大岡　自由ヶ丘,510,983,450,533
2012,大岡,大岡　上石田,917,2187,1086,1101
2012,大岡,大岡　木瀬川,1445,3402,1708,1694
2012,大岡,大岡　平和郷,134,355,168,187
2012,大岡,大岡　北小林,433,1006,509,497
2012,大岡,小林台,123,316,163,153
2012,大岡,大岡　下石田,1845,4603,2228,2375
2012,大岡,大岡　仙岳町,61,175,87,88
2012,大岡,大岡　太田町,147,301,150,151
2012,大岡,大岡　高田,534,1076,579,497
2012,大岡,大岡　竹ノ岬,73,172,89,83
2012,大岡,大岡　駅前町,93,190,119,71
2012,大岡,大岡　中石田,1291,2936,1495,1441
2012,大岡,大岡　富岳町,95,151,60,91
2012,大岡,大岡　富士町,99,213,109,104
2012,大岡,大岡　沼平町,280,644,303,341
2012,大岡,大岡　南小林,1264,2999,1482,1517
2012,大岡,大岡　柏葉尾,273,603,273,330
2012,大岡,大岡　日吉,1526,3637,1803,1834
2012,大岡,大岡　大岡団地,239,440,193,247
2012,静浦,江浦,308,760,362,398
2012,静浦,口野,233,612,292,320
2012,静浦,志下,1215,2943,1480,1463
2012,静浦,獅子浜,397,975,472,503
2012,静浦,多比,244,713,348,365
2012,静浦,馬込,205,519,259,260
2012,愛鷹,青野,819,2054,1058,996
2012,愛鷹,鳥谷,593,1584,800,784
2012,愛鷹,西椎路,1280,3221,1596,1625
2012,愛鷹,東原,916,2395,1205,1190
2012,愛鷹,東椎路,2512,6121,3037,3084
2012,愛鷹,宮本　富士通寮,12,12,12,0
2012,愛鷹,宮本,181,324,186,138
2012,愛鷹,柳沢,257,701,340,361
2012,内浦,内浦小海,110,308,155,153
2012,内浦,内浦重須,234,513,223,290
2012,内浦,内浦重寺,138,354,169,185
2012,内浦,内浦長浜,84,242,120,122
2012,内浦,内浦三津,275,757,361,396
2012,西浦,西浦足保,33,98,46,52
2012,西浦,西浦江梨,81,231,108,123
2012,西浦,西浦河内,61,205,85,120
2012,西浦,西浦木負,125,391,193,198
2012,西浦,西浦久連,108,354,176,178
2012,西浦,西浦久料,24,87,41,46
2012,西浦,西浦古宇,159,272,117,155
2012,西浦,西浦立保,49,160,75,85
2012,西浦,西浦平沢,37,133,58,75
2012,原,植田,169,455,223,232
2012,原,原　新田,503,1203,626,577
2012,原,西添町,536,1326,699,627
2012,原,大塚,2195,5118,2506,2612
2012,原,原　西町,802,2097,1024,1073
2012,原,原　東町,1689,4085,2026,2059
2012,原,原町中一丁目,140,377,191,186
2012,原,原町中二丁目,200,507,264,243
2012,原,原町中三丁目,379,942,443,499
2012,原,一本松,373,822,393,429
2012,原,原　一本松,31,60,29,31
2012,原,桃里,491,1213,617,596
2012,原,原　六軒町,622,1684,823,861
2012,浮島,根古屋,740,1884,963,921
2012,浮島,井出,532,1466,704,762
2012,浮島,平沼,563,1183,621,562
2012,浮島,石川,587,1542,776,766
2012,浮島,西野,0,0,0,0
2012,戸田,井田,39,81,37,44
2012,戸田,戸田　入浜,169,413,217,196
2012,戸田,戸田　上野,95,233,113,120
2012,戸田,戸田　大浦,78,186,91,95
2012,戸田,戸田　大上,49,138,74,64
2012,戸田,戸田　奥南,47,108,49,59
2012,戸田,戸田　大中島,232,511,249,262
2012,戸田,戸田　鬼川,119,283,135,148
2012,戸田,戸田　小山田,75,159,84,75
2012,戸田,戸田　口南,46,101,45,56
2012,戸田,戸田　小中島,98,204,91,113
2012,戸田,戸田　一色,100,240,118,122
2012,戸田,戸田　新田,34,61,34,27
2012,戸田,戸田　大門,80,195,104,91
2012,戸田,戸田　中上,63,147,77,70
2012,戸田,戸田　平戸,61,171,84,87
2012,戸田,戸田　舟山,27,61,30,31
2012,戸田,戸田　御浜,59,113,56,57
2011,第一,大手町一丁目,215,457,219,238
2011,第一,大手町二丁目,183,336,169,167
2011,第一,大手町三丁目,108,202,101,101
2011,第一,大手町四丁目,147,290,132,158
2011,第一,大手町五丁目,125,260,131,129
2011,第一,本字出口町,35,84,41,43
2011,第一,幸町,50,118,61,57
2011,第一,本白銀町,142,268,128,140
2011,第一,白銀町,147,311,155,156
2011,第一,末広町,304,736,347,389
2011,第一,仲町,26,62,26,36
2011,第一,浅間町,67,153,74,79
2011,第一,魚町,82,184,91,93
2011,第一,通横町,6,11,4,7
2011,第一,鵰町,10,27,13,14
2011,第一,新町,4,10,6,4
2011,第一,添地町,170,304,144,160
2011,第一,西条町,191,403,196,207
2011,第一,上土町,120,262,137,125
2011,第一,本字仲町,4,11,5,6
2011,第一,本字浅間町,24,53,25,28
2011,第一,本字新町,11,35,17,18
2011,第一,本錦町,243,495,231,264
2011,第一,本丸子町,107,283,139,144
2011,第一,錦町,63,130,62,68
2011,第一,丸子町,11,19,9,10
2011,第一,八幡町,170,333,160,173
2011,第一,本町,54,94,50,44
2011,第一,下本町,40,78,35,43
2011,第一,大門町,33,84,38,46
2011,第一,真砂町,450,945,460,485
2011,第一,町方町,129,264,130,134
2011,第一,東宮後町,23,51,23,28
2011,第二,旭町,196,440,227,213
2011,第二,本字下小路町,95,204,98,106
2011,第二,本字宮町,83,207,103,104
2011,第二,市道町,334,741,344,397
2011,第二,春日町,72,167,85,82
2011,第二,蓼原町,67,197,96,101
2011,第二,蛇松町,88,218,103,115
2011,第二,本字下河原町,80,193,96,97
2011,第二,本字下河原街出口,92,194,96,98
2011,第二,下河原町,511,1183,573,610
2011,第二,本字下一丁田,149,324,147,177
2011,第二,本字前田,42,92,50,42
2011,第二,本字千本郷林,122,264,122,142
2011,第二,本字千本,72,153,72,81
2011,第二,本字千本,73,162,85,77
2011,第二,千本常盤町,64,123,54,69
2011,第二,常盤町一丁目,87,211,99,112
2011,第二,常盤町二丁目,43,98,48,50
2011,第二,常盤町三丁目,127,308,143,165
2011,第二,本松下,136,318,151,167
2011,第二,本西松下,77,179,86,93
2011,第二,本字松下七反田,78,179,86,93
2011,第二,松下町,21,53,27,26
2011,第二,千本緑町一丁目,93,193,82,111
2011,第二,千本緑町二丁目,39,78,34,44
2011,第二,千本緑町三丁目,58,118,56,62
2011,第二,千本港町,86,200,105,95
2011,第二,千本東町,86,173,85,88
2011,第二,千本西町,114,253,130,123
2011,第二,千本中町,60,174,81,93
2011,第三,我入道秋葉町,199,505,251,254
2011,第三,我入道外新田,1,4,2,2
2011,第三,下香貫石原,163,407,194,213
2011,第三,下香貫藤井原,215,504,263,241
2011,第三,下香貫矢丸,92,230,110,120
2011,第三,我入道稲荷町,148,364,180,184
2011,第三,下香貫牛臥,355,843,403,440
2011,第三,下香貫山宮前,33,88,42,46
2011,第三,我入道江川,178,440,215,225
2011,第三,我入道南条寺,244,585,296,289
2011,第三,香貫が丘,96,332,161,171
2011,第三,下香貫木ノ宮,410,1066,513,553
2011,第三,下香貫前角,75,158,77,81
2011,第三,下香貫猪沼,95,140,52,88
2011,第三,下香貫塩場,173,412,219,193
2011,第三,下香貫前原,133,312,150,162
2011,第三,下香貫浜田,217,550,279,271
2011,第三,下香貫善太夫,182,444,217,227
2011,第三,下香貫上障子,177,358,162,196
2011,第三,下香貫下障子,366,889,430,459
2011,第三,善太夫西原,5,15,8,7
2011,第三,下香貫外原,59,150,73,77
2011,第三,我入道津島町,78,190,97,93
2011,第三,下香貫島郷,387,969,469,500
2011,第三,下香貫塚田,184,427,214,213
2011,第三,下香貫大久保,265,668,298,370
2011,第三,下香貫柿原,194,458,224,234
2011,第三,下香貫清水,195,464,231,233
2011,第三,下香貫馬場,338,786,378,408
2011,第三,下香貫西村,137,288,147,141
2011,第三,下香貫上ノ原,149,353,166,187
2011,第三,下香貫給田,11,28,14,14
2011,第三,我入道浜町,103,263,126,137
2011,第三,我入道蔓陀ヶ原,35,74,36,38
2011,第三,我入道浜方,12,32,14,18
2011,第三,我入道林町,116,289,132,157
2011,第三,我入道東町,163,444,220,224
2011,第三,我入道一本松町,134,371,175,196
2011,第三,下香貫塩満,195,436,203,233
2011,第三,下香貫七面,87,221,119,102
2011,第三,下香貫林ノ下,241,610,310,300
2011,第三,下香貫汐入,256,554,285,269
2011,第三,下香貫樋ノ口,173,413,200,213
2011,第三,下香貫宮脇,413,1044,517,527
2011,第三,下香貫宮原,47,104,51,53
2011,第三,下香貫八重,461,1090,536,554
2011,第三,下香貫八重原,5,12,7,5
2011,第三,下香貫楊原,458,1135,538,597
2011,第三,下香貫六反,8,20,10,10
2011,第四,市場町,330,685,336,349
2011,第四,上香貫大洞,1,3,1,2
2011,第四,上香貫仰天峰,17,39,20,19
2011,第四,上香貫長洞,5,10,5,5
2011,第四,上香貫東坂,6,11,5,6
2011,第四,上香貫蔓陀ヶ原,1,3,2,1
2011,第四,黒瀬町,51,127,60,67
2011,第四,西島町,599,1389,674,715
2011,第四,住吉町,232,562,274,288
2011,第四,三園町,494,1168,580,588
2011,第四,玉江町,218,505,253,252
2011,第四,中瀬町,384,814,397,417
2011,第四,中原町,78,189,98,91
2011,第四,上香貫三貫地,206,572,290,282
2011,第四,上香貫東本郷町,10,14,8,6
2011,第四,上香貫二瀬川町,137,320,163,157
2011,第四,上香貫宮原町,202,464,222,242
2011,第四,上香貫獅子路,11,26,15,11
2011,第四,上香貫槙島町,106,246,119,127
2011,第四,上香貫一ノ洞,3,8,4,4
2011,第四,上香貫三ノ洞,6,12,6,6
2011,第四,上香貫九十九洞,22,55,26,29
2011,第四,上香貫坂口,5,7,3,4
2011,第四,上香貫手城山,4,5,2,3
2011,第四,山ヶ下町,15,37,20,17
2011,第四,上香貫八重,21,51,23,28
2011,第四,上香貫鉛山,3,3,1,2
2011,第四,本郷町,708,1649,759,890
2011,第四,上香貫三園町,29,73,36,37
2011,第四,南本郷町,326,757,362,395
2011,第四,上香貫南本郷町,13,30,14,16
2011,第四,御幸町,479,1099,516,583
2011,第四,吉田町,957,2008,950,1058
2011,第五,泉町,273,654,325,329
2011,第五,庄栄町,381,896,412,484
2011,第五,山王台,383,848,411,437
2011,第五,三枚橋町,403,849,425,424
2011,第五,杉崎町,353,829,402,427
2011,第五,新宿町,776,1535,728,807
2011,第五,三枚橋杉崎町,1,7,4,3
2011,第五,平町,521,998,516,482
2011,第五,高島町,640,1243,608,635
2011,第五,高沢町,842,1729,877,852
2011,第五,高島本町,353,708,370,338
2011,第五,本字下中溝,7,17,8,9
2011,第五,三枚橋荒田,24,63,37,26
2011,第五,三枚橋竹ノ岬,64,178,90,88
2011,第五,日の出町,323,742,362,380
2011,第五,三枚橋日ノ出町,75,171,81,90
2011,第五,富士見町,213,402,222,180
2011,第五,双葉町,263,519,247,272
2011,第五,本田町,515,1138,585,553
2011,第五,三芳町,90,226,94,132
2011,第五,米山町,401,985,458,527
2011,大平,大平,1603,4283,2075,2208
2011,片浜,今沢,2245,4677,2197,2480
2011,片浜,大諏訪,1277,3077,1587,1490
2011,片浜,北今沢,332,893,450,443
2011,片浜,小諏訪,1090,2697,1310,1387
2011,片浜,西間門一丁目,0,0,0,0
2011,片浜,西間門二丁目,30,61,28,33
2011,片浜,西間門三丁目,22,58,28,30
2011,片浜,西間門,1270,2891,1444,1447
2011,片浜,東間門一丁目,11,28,13,15
2011,片浜,東間門二丁目,85,206,101,105
2011,片浜,東間門三丁目,65,145,69,76
2011,片浜,東間門,262,627,308,319
2011,片浜,松長,978,2393,1186,1207
2011,金岡,足高,575,1174,598,576
2011,金岡,共栄町,284,596,312,284
2011,金岡,江原町,444,1006,503,503
2011,金岡,神田町,396,853,461,392
2011,金岡,北園町,76,186,92,94
2011,金岡,寿町,581,1225,639,586
2011,金岡,沢田,13,38,21,17
2011,金岡,沢田町,117,293,144,149
2011,金岡,岡一色,1346,3366,1708,1658
2011,金岡,北高島町,447,946,486,460
2011,金岡,新沢田町,630,1485,752,733
2011,金岡,駿河台,410,998,517,481
2011,金岡,高尾台,232,557,292,265
2011,金岡,高砂町,331,833,408,425
2011,金岡,五月町,527,1128,560,568
2011,金岡,筒井町,177,392,182,210
2011,金岡,中沢田,631,1611,816,795
2011,金岡,西熊堂,412,1098,551,547
2011,金岡,西沢田,1461,3458,1774,1684
2011,金岡,沼北町一丁目,540,1156,621,535
2011,金岡,沼北町二丁目,376,935,470,465
2011,金岡,花園町,288,611,318,293
2011,金岡,東熊堂,520,1224,637,587
2011,金岡,東沢田,391,997,511,486
2011,金岡,宮前町,205,506,240,266
2011,金岡,松沢町,288,713,347,366
2011,金岡,緑ヶ丘,122,259,145,114
2011,金岡,岡宮,2298,5584,2793,2791
2011,金岡,柳町,476,1021,530,491
2011,金岡,豊町,316,822,405,417
2011,金岡,若葉町,636,1406,727,679
2011,大岡,大岡　石田ヶ丘,74,182,88,94
2011,大岡,大岡　駅前町,520,1210,584,626
2011,大岡,大岡,1,1,1,0
2011,大岡,大岡　自由ヶ丘,481,935,420,515
2011,大岡,大岡　上石田,929,2213,1104,1109
2011,大岡,大岡　木瀬川,1433,3401,1723,1678
2011,大岡,大岡　平和郷,135,354,167,187
2011,大岡,大岡　北小林,406,952,481,471
2011,大岡,小林台,128,315,163,152
2011,大岡,大岡　下石田,1831,4605,2244,2361
2011,大岡,大岡　仙岳町,67,193,96,97
2011,大岡,大岡　太田町,147,305,157,148
2011,大岡,大岡　高田,534,1070,584,486
2011,大岡,大岡　竹ノ岬,75,181,94,87
2011,大岡,大岡　駅前町,81,178,107,71
2011,大岡,大岡　中石田,1276,2959,1520,1439
2011,大岡,大岡　富岳町,92,149,59,90
2011,大岡,大岡　富士町,99,212,109,103
2011,大岡,大岡　沼平町,277,651,306,345
2011,大岡,大岡　南小林,1288,3066,1515,1551
2011,大岡,大岡　柏葉尾,270,593,265,328
2011,大岡,大岡　日吉,1524,3662,1813,1849
2011,大岡,大岡　大岡団地,246,460,208,252
2011,静浦,江浦,315,793,380,413
2011,静浦,口野,242,638,304,334
2011,静浦,志下,1225,3015,1501,1514
2011,静浦,獅子浜,404,1018,493,525
2011,静浦,多比,245,741,365,376
2011,静浦,馬込,206,535,269,266
2011,愛鷹,青野,804,2075,1080,995
2011,愛鷹,鳥谷,600,1626,830,796
2011,愛鷹,西椎路,1246,3197,1594,1603
2011,愛鷹,東原,921,2434,1230,1204
2011,愛鷹,東椎路,2495,6111,3020,3091
2011,愛鷹,宮本　富士通寮,18,18,18,0
2011,愛鷹,宮本,187,337,185,152
2011,愛鷹,柳沢,260,719,354,365
2011,内浦,内浦小海,117,323,161,162
2011,内浦,内浦重須,236,521,229,292
2011,内浦,内浦重寺,139,359,167,192
2011,内浦,内浦長浜,88,251,129,122
2011,内浦,内浦三津,276,766,362,404
2011,西浦,西浦足保,32,101,47,54
2011,西浦,西浦江梨,83,238,111,127
2011,西浦,西浦河内,63,208,89,119
2011,西浦,西浦木負,122,396,196,200
2011,西浦,西浦久連,106,358,180,178
2011,西浦,西浦久料,26,93,43,50
2011,西浦,西浦古宇,153,276,115,161
2011,西浦,西浦立保,49,162,73,89
2011,西浦,西浦平沢,35,130,60,70
2011,原,植田,167,469,230,239
2011,原,原　新田,506,1220,633,587
2011,原,西添町,551,1364,724,640
2011,原,大塚,2224,5254,2575,2679
2011,原,原　西町,800,2091,1027,1064
2011,原,原　東町,1697,4188,2080,2108
2011,原,原町中一丁目,128,363,187,176
2011,原,原町中二丁目,199,524,272,252
2011,原,原町中三丁目,379,955,455,500
2011,原,一本松,387,839,392,447
2011,原,原　一本松,30,62,30,32
2011,原,桃里,476,1226,620,606
2011,原,原　六軒町,612,1673,821,852
2011,浮島,根古屋,718,1880,966,914
2011,浮島,井出,531,1485,708,777
2011,浮島,平沼,548,1183,609,574
2011,浮島,石川,584,1568,784,784
2011,浮島,西野,0,0,0,0
2011,戸田,井田,39,82,38,44
2011,戸田,戸田　入浜,170,417,221,196
2011,戸田,戸田　上野,97,241,120,121
2011,戸田,戸田　大浦,84,203,96,107
2011,戸田,戸田　大上,49,140,78,62
2011,戸田,戸田　奥南,49,114,51,63
2011,戸田,戸田　大中島,240,534,258,276
2011,戸田,戸田　鬼川,120,289,139,150
2011,戸田,戸田　小山田,76,166,88,78
2011,戸田,戸田　口南,46,104,48,56
2011,戸田,戸田　小中島,95,207,92,115
2011,戸田,戸田　一色,102,246,122,124
2011,戸田,戸田　新田,33,61,35,26
2011,戸田,戸田　大門,80,199,102,97
2011,戸田,戸田　中上,67,156,83,73
2011,戸田,戸田　平戸,65,176,86,90
2011,戸田,戸田　舟山,27,64,30,34
2011,戸田,戸田　御浜,60,122,60,62
2010,第一,大手町一丁目,216,457,226,231
2010,第一,大手町二丁目,176,328,159,169
2010,第一,大手町三丁目,98,195,99,96
2010,第一,大手町四丁目,149,302,144,158
2010,第一,大手町五丁目,123,272,132,140
2010,第一,本字出口町,35,82,41,41
2010,第一,幸町,51,123,65,58
2010,第一,本白銀町,147,271,129,142
2010,第一,白銀町,143,313,157,156
2010,第一,末広町,305,737,348,389
2010,第一,仲町,25,61,26,35
2010,第一,浅間町,7,19,6,13
2010,第一,魚町,44,107,53,54
2010,第一,通横町,6,12,4,8
2010,第一,鵰町,10,27,13,14
2010,第一,新町,4,9,6,3
2010,第一,添地町,181,331,152,179
2010,第一,西条町,196,419,204,215
2010,第一,上土町,119,261,137,124
2010,第一,本字仲町,4,11,5,6
2010,第一,本字浅間町,25,55,26,29
2010,第一,本字新町,13,39,18,21
2010,第一,本錦町,241,501,234,267
2010,第一,本丸子町,115,301,145,156
2010,第一,錦町,63,132,64,68
2010,第一,丸子町,12,22,10,12
2010,第一,八幡町,164,333,152,181
2010,第一,本町,49,86,46,40
2010,第一,下本町,43,87,40,47
2010,第一,大門町,33,82,37,45
2010,第一,真砂町,452,970,466,504
2010,第一,町方町,129,271,140,131
2010,第一,東宮後町,23,52,23,29
2010,第二,旭町,192,443,229,214
2010,第二,本字下小路町,95,203,98,105
2010,第二,本字宮町,83,216,104,112
2010,第二,市道町,329,745,343,402
2010,第二,春日町,71,168,85,83
2010,第二,蓼原町,66,197,94,103
2010,第二,蛇松町,87,212,99,113
2010,第二,本字下河原町,79,190,95,95
2010,第二,本字下河原街出口,82,182,89,93
2010,第二,下河原町,506,1199,581,618
2010,第二,本字下一丁田,154,332,149,183
2010,第二,本字前田,39,92,50,42
2010,第二,本字千本郷林,123,271,128,143
2010,第二,本字千本,70,150,70,80
2010,第二,本字千本,74,172,91,81
2010,第二,千本常盤町,70,132,54,78
2010,第二,常盤町一丁目,87,217,100,117
2010,第二,常盤町二丁目,42,98,46,52
2010,第二,常盤町三丁目,123,308,141,167
2010,第二,本松下,140,335,152,183
2010,第二,本西松下,76,180,88,92
2010,第二,本字松下七反田,75,184,88,96
2010,第二,松下町,20,48,25,23
2010,第二,千本緑町一丁目,93,199,84,115
2010,第二,千本緑町二丁目,41,84,38,46
2010,第二,千本緑町三丁目,63,129,61,68
2010,第二,千本港町,88,209,111,98
2010,第二,千本東町,79,165,78,87
2010,第二,千本西町,122,266,135,131
2010,第二,千本中町,58,173,81,92
2010,第三,我入道秋葉町,195,500,248,252
2010,第三,我入道外新田,1,4,2,2
2010,第三,下香貫石原,164,400,191,209
2010,第三,下香貫藤井原,226,527,275,252
2010,第三,下香貫矢丸,88,223,111,112
2010,第三,我入道稲荷町,149,366,182,184
2010,第三,下香貫牛臥,354,846,398,448
2010,第三,下香貫山宮前,33,90,43,47
2010,第三,我入道江川,182,439,212,227
2010,第三,我入道南条寺,245,603,295,308
2010,第三,香貫が丘,93,324,157,167
2010,第三,下香貫木ノ宮,405,1058,511,547
2010,第三,下香貫前角,76,168,82,86
2010,第三,下香貫猪沼,95,136,49,87
2010,第三,下香貫塩場,170,411,216,195
2010,第三,下香貫前原,127,301,141,160
2010,第三,下香貫浜田,215,562,291,271
2010,第三,下香貫善太夫,182,459,224,235
2010,第三,下香貫上障子,175,360,158,202
2010,第三,下香貫下障子,361,874,421,453
2010,第三,善太夫西原,5,16,8,8
2010,第三,下香貫外原,59,146,72,74
2010,第三,我入道津島町,77,188,99,89
2010,第三,下香貫島郷,373,938,453,485
2010,第三,下香貫塚田,178,436,214,222
2010,第三,下香貫大久保,260,660,300,360
2010,第三,下香貫柿原,185,441,210,231
2010,第三,下香貫清水,197,478,238,240
2010,第三,下香貫馬場,336,784,391,393
2010,第三,下香貫西村,126,280,137,143
2010,第三,下香貫上ノ原,145,353,161,192
2010,第三,下香貫給田,9,23,11,12
2010,第三,我入道浜町,108,269,132,137
2010,第三,我入道蔓陀ヶ原,36,77,38,39
2010,第三,我入道浜方,13,34,15,19
2010,第三,我入道林町,113,279,127,152
2010,第三,我入道東町,159,429,218,211
2010,第三,我入道一本松町,132,369,172,197
2010,第三,下香貫塩満,204,448,218,230
2010,第三,下香貫七面,90,227,123,104
2010,第三,下香貫林ノ下,238,613,311,302
2010,第三,下香貫汐入,240,531,275,256
2010,第三,下香貫樋ノ口,161,388,188,200
2010,第三,下香貫宮脇,410,1045,515,530
2010,第三,下香貫宮原,43,97,47,50
2010,第三,下香貫八重,466,1113,542,571
2010,第三,下香貫八重原,5,12,7,5
2010,第三,下香貫楊原,468,1165,543,622
2010,第三,下香貫六反,7,18,8,10
2010,第四,市場町,335,705,344,361
2010,第四,上香貫大洞,1,3,1,2
2010,第四,上香貫仰天峰,18,45,24,21
2010,第四,上香貫長洞,6,11,6,5
2010,第四,上香貫東坂,6,11,5,6
2010,第四,上香貫蔓陀ヶ原,1,3,2,1
2010,第四,黒瀬町,53,136,67,69
2010,第四,西島町,609,1403,680,723
2010,第四,住吉町,232,564,278,286
2010,第四,三園町,470,1080,546,534
2010,第四,玉江町,222,525,266,259
2010,第四,中瀬町,399,831,411,420
2010,第四,中原町,77,188,96,92
2010,第四,上香貫三貫地,211,577,290,287
2010,第四,上香貫東本郷町,13,17,10,7
2010,第四,上香貫二瀬川町,134,323,162,161
2010,第四,上香貫宮原町,204,468,219,249
2010,第四,上香貫獅子路,10,23,13,10
2010,第四,上香貫槙島町,109,245,121,124
2010,第四,上香貫一ノ洞,3,8,4,4
2010,第四,上香貫三ノ洞,6,13,7,6
2010,第四,上香貫九十九洞,21,51,25,26
2010,第四,上香貫坂口,5,7,3,4
2010,第四,上香貫手城山,4,5,2,3
2010,第四,山ヶ下町,14,37,21,16
2010,第四,上香貫八重,23,53,24,29
2010,第四,上香貫鉛山,3,3,2,1
2010,第四,本郷町,717,1666,768,898
2010,第四,上香貫三園町,29,74,36,38
2010,第四,南本郷町,331,780,374,406
2010,第四,上香貫南本郷町,14,30,14,16
2010,第四,御幸町,491,1124,537,587
2010,第四,吉田町,970,2087,995,1092
2010,第五,泉町,267,666,327,339
2010,第五,庄栄町,383,905,414,491
2010,第五,山王台,396,863,420,443
2010,第五,三枚橋町,397,861,432,429
2010,第五,杉崎町,352,828,398,430
2010,第五,新宿町,771,1562,739,823
2010,第五,三枚橋杉崎町,1,7,4,3
2010,第五,平町,497,977,505,472
2010,第五,高島町,640,1241,601,640
2010,第五,高沢町,831,1743,877,866
2010,第五,高島本町,358,725,372,353
2010,第五,本字下中溝,7,17,8,9
2010,第五,三枚橋荒田,25,71,39,32
2010,第五,三枚橋竹ノ岬,60,165,82,83
2010,第五,日の出町,333,785,383,402
2010,第五,三枚橋日ノ出町,76,188,90,98
2010,第五,富士見町,217,432,234,198
2010,第五,双葉町,270,524,248,276
2010,第五,本田町,529,1169,606,563
2010,第五,三芳町,88,224,91,133
2010,第五,米山町,390,980,457,523
2010,大平,大平,1611,4349,2095,2254
2010,片浜,今沢,2239,4750,2239,2511
2010,片浜,大諏訪,1248,3040,1563,1477
2010,片浜,北今沢,326,883,445,438
2010,片浜,小諏訪,1079,2692,1318,1374
2010,片浜,西間門一丁目,0,0,0,0
2010,片浜,西間門二丁目,32,63,30,33
2010,片浜,西間門三丁目,22,56,28,28
2010,片浜,西間門,1286,2975,1503,1472
2010,片浜,東間門一丁目,12,28,13,15
2010,片浜,東間門二丁目,86,202,97,105
2010,片浜,東間門三丁目,64,148,70,78
2010,片浜,東間門,255,624,311,313
2010,片浜,松長,988,2425,1199,1226
2010,金岡,足高,597,1219,619,600
2010,金岡,共栄町,283,599,316,283
2010,金岡,江原町,446,1021,515,506
2010,金岡,神田町,416,892,486,406
2010,金岡,北園町,77,192,98,94
2010,金岡,寿町,595,1249,647,602
2010,金岡,沢田,12,40,25,15
2010,金岡,沢田町,118,289,140,149
2010,金岡,岡一色,1348,3408,1731,1677
2010,金岡,北高島町,437,955,492,463
2010,金岡,新沢田町,628,1489,753,736
2010,金岡,駿河台,408,1022,530,492
2010,金岡,高尾台,228,557,297,260
2010,金岡,高砂町,335,843,422,421
2010,金岡,五月町,512,1127,565,562
2010,金岡,筒井町,174,397,189,208
2010,金岡,中沢田,620,1594,812,782
2010,金岡,西熊堂,413,1111,555,556
2010,金岡,西沢田,1418,3382,1743,1639
2010,金岡,沼北町一丁目,555,1210,644,566
2010,金岡,沼北町二丁目,384,954,487,467
2010,金岡,花園町,298,638,329,309
2010,金岡,東熊堂,518,1210,620,590
2010,金岡,東沢田,379,966,493,473
2010,金岡,宮前町,209,527,254,273
2010,金岡,松沢町,282,718,342,376
2010,金岡,緑ヶ丘,114,232,130,102
2010,金岡,岡宮,2258,5498,2742,2756
2010,金岡,柳町,479,1023,533,490
2010,金岡,豊町,316,840,416,424
2010,金岡,若葉町,614,1350,691,659
2010,大岡,大岡　石田ヶ丘,75,186,95,91
2010,大岡,大岡　駅前町,524,1223,592,631
2010,大岡,大岡　自由ヶ丘,448,883,413,470
2010,大岡,大岡　上石田,906,2186,1094,1092
2010,大岡,大岡　木瀬川,1402,3341,1694,1647
2010,大岡,大岡　平和郷,137,364,174,190
2010,大岡,大岡　北小林,397,947,481,466
2010,大岡,小林台,127,319,165,154
2010,大岡,大岡　下石田,1823,4644,2258,2386
2010,大岡,大岡　仙岳町,62,189,92,97
2010,大岡,大岡　太田町,151,318,165,153
2010,大岡,大岡　高田,518,1055,573,482
2010,大岡,大岡　竹ノ岬,75,180,93,87
2010,大岡,大岡　駅前町,64,156,89,67
2010,大岡,大岡　中石田,1297,3017,1563,1454
2010,大岡,大岡　富岳町,91,150,57,93
2010,大岡,大岡　富士町,102,214,111,103
2010,大岡,大岡　沼平町,286,660,312,348
2010,大岡,大岡　南小林,1253,3031,1504,1527
2010,大岡,大岡　柏葉尾,280,609,275,334
2010,大岡,大岡　日吉,1536,3730,1852,1878
2010,大岡,大岡　大岡団地,254,478,213,265
2010,静浦,江浦,313,803,380,423
2010,静浦,口野,240,640,304,336
2010,静浦,志下,1196,2999,1492,1507
2010,静浦,獅子浜,403,1045,499,546
2010,静浦,多比,248,755,372,383
2010,静浦,馬込,211,561,283,278
2010,愛鷹,青野,784,2078,1090,988
2010,愛鷹,鳥谷,600,1625,838,787
2010,愛鷹,西椎路,1249,3250,1619,1631
2010,愛鷹,東原,908,2448,1231,1217
2010,愛鷹,東椎路,2486,6160,3057,3103
2010,愛鷹,宮本　富士通寮,29,29,29,0
2010,愛鷹,宮本,196,335,181,154
2010,愛鷹,柳沢,266,741,362,379
2010,内浦,内浦小海,114,323,163,160
2010,内浦,内浦重須,239,535,233,302
2010,内浦,内浦重寺,139,350,163,187
2010,内浦,内浦長浜,86,250,126,124
2010,内浦,内浦三津,276,777,370,407
2010,西浦,西浦足保,32,104,49,55
2010,西浦,西浦江梨,85,243,114,129
2010,西浦,西浦河内,65,216,94,122
2010,西浦,西浦木負,122,403,200,203
2010,西浦,西浦久連,108,369,183,186
2010,西浦,西浦久料,26,90,42,48
2010,西浦,西浦古宇,158,283,118,165
2010,西浦,西浦立保,49,167,77,90
2010,西浦,西浦平沢,35,130,60,70
2010,原,植田,177,485,242,243
2010,原,原　新田,514,1258,652,606
2010,原,西添町,533,1344,708,636
2010,原,大塚,2205,5277,2588,2689
2010,原,原　西町,807,2102,1041,1061
2010,原,原　東町,1712,4256,2113,2143
2010,原,原町中一丁目,133,379,192,187
2010,原,原町中二丁目,189,510,264,246
2010,原,原町中三丁目,374,965,454,511
2010,原,一本松,389,862,407,455
2010,原,原　一本松,29,56,31,25
2010,原,桃里,478,1241,631,610
2010,原,原　六軒町,610,1680,825,855
2010,浮島,根古屋,718,1901,976,925
2010,浮島,井出,534,1498,715,783
2010,浮島,平沼,525,1161,588,573
2010,浮島,石川,583,1564,786,778
2010,浮島,西野,0,0,0,0
2010,戸田,井田,39,83,37,46
2010,戸田,戸田　入浜,179,438,229,209
2010,戸田,戸田　上野,102,256,126,130
2010,戸田,戸田　大浦,86,212,104,108
2010,戸田,戸田　大上,49,143,79,64
2010,戸田,戸田　奥南,50,119,55,64
2010,戸田,戸田　大中島,241,548,271,277
2010,戸田,戸田　鬼川,117,287,143,144
2010,戸田,戸田　小山田,78,175,92,83
2010,戸田,戸田　口南,46,110,50,60
2010,戸田,戸田　小中島,98,210,95,115
2010,戸田,戸田　一色,100,250,125,125
2010,戸田,戸田　新田,32,58,34,24
2010,戸田,戸田　大門,76,200,104,96
2010,戸田,戸田　中上,65,155,80,75
2010,戸田,戸田　平戸,67,181,89,92
2010,戸田,戸田　舟山,30,71,35,36
2010,戸田,戸田　御浜,62,120,64,56
2009,第一,大手町一丁目,215,448,222,226
2009,第一,大手町二丁目,180,338,167,171
2009,第一,大手町三丁目,98,196,101,95
2009,第一,大手町四丁目,152,307,149,158
2009,第一,大手町五丁目,121,275,133,142
2009,第一,本字出口町,36,84,42,42
2009,第一,幸町,51,128,64,64
2009,第一,本白銀町,148,281,132,149
2009,第一,白銀町,145,314,155,159
2009,第一,末広町,301,758,359,399
2009,第一,仲町,27,65,29,36
2009,第一,浅間町,13,32,15,17
2009,第一,魚町,10,34,16,18
2009,第一,通横町,6,14,6,8
2009,第一,鵰町,10,28,13,15
2009,第一,新町,4,9,6,3
2009,第一,添地町,185,354,160,194
2009,第一,西条町,189,410,201,209
2009,第一,上土町,123,274,139,135
2009,第一,本字仲町,4,11,5,6
2009,第一,本字浅間町,25,56,28,28
2009,第一,本字新町,13,38,17,21
2009,第一,本錦町,240,510,238,272
2009,第一,本丸子町,115,299,143,156
2009,第一,錦町,65,138,66,72
2009,第一,丸子町,11,20,9,11
2009,第一,八幡町,168,336,158,178
2009,第一,本町,45,81,44,37
2009,第一,下本町,44,92,45,47
2009,第一,大門町,31,82,38,44
2009,第一,真砂町,449,987,483,504
2009,第一,町方町,122,270,139,131
2009,第一,東宮後町,22,53,24,29
2009,第二,旭町,200,456,231,225
2009,第二,本字下小路町,92,205,100,105
2009,第二,本字宮町,86,219,107,112
2009,第二,市道町,324,740,341,399
2009,第二,春日町,70,170,87,83
2009,第二,蓼原町,67,199,93,106
2009,第二,蛇松町,85,209,98,111
2009,第二,本字下河原町,78,192,98,94
2009,第二,本字下河原街出口,75,181,88,93
2009,第二,下河原町,497,1189,577,612
2009,第二,本字下一丁田,147,317,140,177
2009,第二,本字前田,40,101,54,47
2009,第二,本字千本郷林,122,285,133,152
2009,第二,本字千本,69,161,77,84
2009,第二,本字千本,69,166,87,79
2009,第二,千本常盤町,68,133,58,75
2009,第二,常盤町一丁目,84,214,100,114
2009,第二,常盤町二丁目,39,90,40,50
2009,第二,常盤町三丁目,123,305,135,170
2009,第二,本松下,145,343,150,193
2009,第二,本西松下,71,177,81,96
2009,第二,本字松下七反田,82,194,92,102
2009,第二,松下町,19,44,23,21
2009,第二,千本緑町一丁目,95,208,86,122
2009,第二,千本緑町二丁目,46,93,41,52
2009,第二,千本緑町三丁目,62,124,58,66
2009,第二,千本港町,84,214,110,104
2009,第二,千本東町,80,165,79,86
2009,第二,千本西町,131,277,138,139
2009,第二,千本中町,59,175,82,93
2009,第三,我入道秋葉町,194,510,251,259
2009,第三,我入道外新田,1,4,2,2
2009,第三,下香貫石原,161,394,194,200
2009,第三,下香貫藤井原,232,545,276,269
2009,第三,下香貫矢丸,84,216,108,108
2009,第三,我入道稲荷町,142,354,172,182
2009,第三,下香貫牛臥,357,850,401,449
2009,第三,下香貫山宮前,32,87,41,46
2009,第三,我入道江川,170,415,201,214
2009,第三,我入道南条寺,242,612,298,314
2009,第三,香貫が丘,91,319,155,164
2009,第三,下香貫木ノ宮,398,1045,507,538
2009,第三,下香貫前角,77,168,82,86
2009,第三,下香貫猪沼,98,139,49,90
2009,第三,下香貫塩場,168,415,212,203
2009,第三,下香貫前原,113,282,132,150
2009,第三,下香貫浜田,222,578,296,282
2009,第三,下香貫善太夫,177,467,228,239
2009,第三,下香貫上障子,165,354,165,189
2009,第三,下香貫下障子,358,872,415,457
2009,第三,善太夫西原,5,16,8,8
2009,第三,下香貫外原,56,139,67,72
2009,第三,我入道津島町,77,192,101,91
2009,第三,下香貫島郷,380,958,468,490
2009,第三,下香貫塚田,176,453,223,230
2009,第三,下香貫大久保,261,664,301,363
2009,第三,下香貫柿原,188,456,221,235
2009,第三,下香貫清水,198,489,244,245
2009,第三,下香貫馬場,331,774,386,388
2009,第三,下香貫西村,131,289,146,143
2009,第三,下香貫上ノ原,146,353,163,190
2009,第三,下香貫給田,12,29,13,16
2009,第三,我入道浜町,106,274,132,142
2009,第三,我入道蔓陀ヶ原,37,84,40,44
2009,第三,我入道浜方,16,40,16,24
2009,第三,我入道林町,114,291,135,156
2009,第三,我入道東町,165,452,227,225
2009,第三,我入道一本松町,135,384,174,210
2009,第三,下香貫塩満,197,456,225,231
2009,第三,下香貫七面,88,221,117,104
2009,第三,下香貫林ノ下,225,601,303,298
2009,第三,下香貫汐入,232,514,269,245
2009,第三,下香貫樋ノ口,166,407,193,214
2009,第三,下香貫宮脇,397,1004,492,512
2009,第三,下香貫宮原,44,100,47,53
2009,第三,下香貫八重,476,1130,549,581
2009,第三,下香貫八重原,5,13,8,5
2009,第三,下香貫楊原,451,1141,536,605
2009,第三,下香貫六反,7,18,8,10
2009,第四,市場町,339,710,346,364
2009,第四,上香貫大洞,1,4,2,2
2009,第四,上香貫仰天峰,18,47,25,22
2009,第四,上香貫長洞,6,11,6,5
2009,第四,上香貫東坂,7,12,5,7
2009,第四,上香貫蔓陀ヶ原,1,3,2,1
2009,第四,黒瀬町,47,122,61,61
2009,第四,西島町,611,1427,702,725
2009,第四,住吉町,235,566,281,285
2009,第四,三園町,447,1010,524,486
2009,第四,玉江町,216,523,263,260
2009,第四,中瀬町,388,818,403,415
2009,第四,中原町,78,195,100,95
2009,第四,上香貫三貫地,206,561,286,275
2009,第四,上香貫東本郷町,13,17,10,7
2009,第四,上香貫二瀬川町,130,323,164,159
2009,第四,上香貫宮原町,213,486,223,263
2009,第四,上香貫獅子路,10,22,12,10
2009,第四,上香貫槙島町,104,228,111,117
2009,第四,上香貫一ノ洞,3,8,4,4
2009,第四,上香貫三ノ洞,6,13,7,6
2009,第四,上香貫九十九洞,19,51,25,26
2009,第四,上香貫坂口,5,7,3,4
2009,第四,上香貫手城山,4,5,2,3
2009,第四,山ヶ下町,13,35,19,16
2009,第四,上香貫八重,23,52,24,28
2009,第四,上香貫鉛山,2,2,1,1
2009,第四,本郷町,712,1656,768,888
2009,第四,上香貫三園町,31,83,39,44
2009,第四,南本郷町,323,761,365,396
2009,第四,上香貫南本郷町,14,30,15,15
2009,第四,御幸町,485,1137,540,597
2009,第四,吉田町,966,2105,1015,1090
2009,第五,泉町,272,683,339,344
2009,第五,庄栄町,394,937,429,508
2009,第五,山王台,393,869,425,444
2009,第五,三枚橋町,383,836,425,411
2009,第五,杉崎町,362,851,425,426
2009,第五,新宿町,773,1582,755,827
2009,第五,三枚橋杉崎町,1,7,4,3
2009,第五,平町,498,991,511,480
2009,第五,高島町,612,1203,587,616
2009,第五,高沢町,831,1753,892,861
2009,第五,高島本町,361,736,383,353
2009,第五,本字下中溝,7,17,8,9
2009,第五,三枚橋荒田,22,61,31,30
2009,第五,三枚橋竹ノ岬,54,154,76,78
2009,第五,日の出町,323,763,385,378
2009,第五,三枚橋日ノ出町,76,190,92,98
2009,第五,富士見町,230,465,255,210
2009,第五,双葉町,279,539,254,285
2009,第五,本田町,548,1201,619,582
2009,第五,三芳町,92,229,99,130
2009,第五,米山町,386,992,465,527
2009,大平,大平,1609,4371,2099,2272
2009,片浜,今沢,2194,4710,2217,2493
2009,片浜,大諏訪,1220,3034,1552,1482
2009,片浜,北今沢,338,921,464,457
2009,片浜,小諏訪,1071,2684,1310,1374
2009,片浜,西間門一丁目,0,0,0,0
2009,片浜,西間門二丁目,31,66,32,34
2009,片浜,西間門三丁目,22,55,27,28
2009,片浜,西間門,1291,3022,1523,1499
2009,片浜,東間門一丁目,9,23,11,12
2009,片浜,東間門二丁目,87,210,98,112
2009,片浜,東間門三丁目,63,153,75,78
2009,片浜,東間門,260,623,306,317
2009,片浜,松長,951,2351,1161,1190
2009,金岡,足高,600,1230,630,600
2009,金岡,共栄町,280,590,314,276
2009,金岡,江原町,443,1005,506,499
2009,金岡,神田町,412,903,493,410
2009,金岡,北園町,81,202,104,98
2009,金岡,寿町,602,1279,658,621
2009,金岡,沢田,13,42,26,16
2009,金岡,沢田町,118,302,142,160
2009,金岡,岡一色,1326,3367,1710,1657
2009,金岡,北高島町,454,975,496,479
2009,金岡,新沢田町,631,1477,745,732
2009,金岡,駿河台,400,994,519,475
2009,金岡,高尾台,224,554,294,260
2009,金岡,高砂町,328,824,413,411
2009,金岡,五月町,519,1146,566,580
2009,金岡,筒井町,150,348,174,174
2009,金岡,中沢田,630,1621,820,801
2009,金岡,西熊堂,423,1124,571,553
2009,金岡,西沢田,1393,3416,1761,1655
2009,金岡,沼北町一丁目,552,1214,646,568
2009,金岡,沼北町二丁目,379,958,489,469
2009,金岡,花園町,309,659,330,329
2009,金岡,東熊堂,518,1227,633,594
2009,金岡,東沢田,376,965,486,479
2009,金岡,宮前町,216,527,251,276
2009,金岡,松沢町,285,715,339,376
2009,金岡,緑ヶ丘,81,170,90,80
2009,金岡,岡宮,2264,5566,2774,2792
2009,金岡,柳町,473,1036,541,495
2009,金岡,豊町,316,856,417,439
2009,金岡,若葉町,625,1402,708,694
2009,大岡,大岡　石田ヶ丘,77,195,98,97
2009,大岡,大岡　駅前町,535,1253,608,645
2009,大岡,大岡　自由ヶ丘,434,876,426,450
2009,大岡,大岡　上石田,927,2250,1122,1128
2009,大岡,大岡　木瀬川,1378,3273,1649,1624
2009,大岡,大岡　平和郷,135,354,169,185
2009,大岡,大岡　北小林,394,951,481,470
2009,大岡,小林台,126,318,160,158
2009,大岡,大岡　下石田,1811,4668,2262,2406
2009,大岡,大岡　仙岳町,67,203,101,102
2009,大岡,大岡　太田町,154,325,165,160
2009,大岡,大岡　高田,516,1047,571,476
2009,大岡,大岡　竹ノ岬,75,186,95,91
2009,大岡,大岡　駅前町,67,187,100,87
2009,大岡,大岡　中石田,1269,3051,1569,1482
2009,大岡,大岡　富岳町,88,151,57,94
2009,大岡,大岡　富士町,101,223,112,111
2009,大岡,大岡　沼平町,281,690,322,368
2009,大岡,大岡　南小林,1189,2901,1444,1457
2009,大岡,大岡　柏葉尾,284,616,277,339
2009,大岡,大岡　日吉,1532,3764,1870,1894
2009,大岡,大岡　大岡団地,255,482,219,263
2009,静浦,江浦,315,815,387,428
2009,静浦,口野,242,660,314,346
2009,静浦,志下,1142,2906,1454,1452
2009,静浦,獅子浜,408,1076,517,559
2009,静浦,多比,249,768,380,388
2009,静浦,馬込,212,571,287,284
2009,愛鷹,青野,778,2102,1095,1007
2009,愛鷹,鳥谷,594,1632,841,791
2009,愛鷹,西椎路,1265,3330,1657,1673
2009,愛鷹,東原,913,2446,1221,1225
2009,愛鷹,東椎路,2502,6204,3066,3138
2009,愛鷹,宮本　富士通寮,35,35,35,0
2009,愛鷹,宮本,206,357,191,166
2009,愛鷹,柳沢,263,739,362,377
2009,内浦,内浦小海,113,328,165,163
2009,内浦,内浦重須,238,544,234,310
2009,内浦,内浦重寺,139,356,165,191
2009,内浦,内浦長浜,87,261,131,130
2009,内浦,内浦三津,276,773,369,404
2009,西浦,西浦足保,31,103,48,55
2009,西浦,西浦江梨,88,252,118,134
2009,西浦,西浦河内,62,220,96,124
2009,西浦,西浦木負,124,411,201,210
2009,西浦,西浦久連,106,369,184,185
2009,西浦,西浦久料,26,83,40,43
2009,西浦,西浦古宇,155,280,119,161
2009,西浦,西浦立保,49,170,80,90
2009,西浦,西浦平沢,36,135,61,74
2009,原,植田,175,484,245,239
2009,原,原　新田,496,1236,641,595
2009,原,西添町,548,1370,726,644
2009,原,大塚,2215,5343,2615,2728
2009,原,原　西町,809,2148,1069,1079
2009,原,原　東町,1696,4278,2127,2151
2009,原,原町中一丁目,135,390,203,187
2009,原,原町中二丁目,190,520,267,253
2009,原,原町中三丁目,377,1023,491,532
2009,原,一本松,305,779,387,392
2009,原,原　一本松,32,61,30,31
2009,原,桃里,486,1272,649,623
2009,原,原　六軒町,604,1667,818,849
2009,浮島,根古屋,709,1915,968,947
2009,浮島,井出,525,1498,724,774
2009,浮島,平沼,517,1157,583,574
2009,浮島,石川,571,1576,786,790
2009,浮島,西野,1,1,1,0
2009,戸田,井田,37,80,37,43
2009,戸田,戸田　入浜,182,450,233,217
2009,戸田,戸田　上野,102,256,126,130
2009,戸田,戸田　大浦,87,218,108,110
2009,戸田,戸田　大上,50,150,80,70
2009,戸田,戸田　奥南,50,119,54,65
2009,戸田,戸田　大中島,244,566,281,285
2009,戸田,戸田　鬼川,121,302,151,151
2009,戸田,戸田　小山田,85,193,101,92
2009,戸田,戸田　口南,47,107,48,59
2009,戸田,戸田　小中島,101,224,103,121
2009,戸田,戸田　一色,99,254,124,130
2009,戸田,戸田　新田,33,60,35,25
2009,戸田,戸田　大門,72,195,101,94
2009,戸田,戸田　中上,62,150,77,73
2009,戸田,戸田　平戸,66,183,94,89
2009,戸田,戸田　舟山,30,70,35,35
2009,戸田,戸田　御浜,63,122,62,60
2008,第一,大手町一丁目,205,427,214,213
2008,第一,大手町二丁目,188,347,173,174
2008,第一,大手町三丁目,99,205,107,98
2008,第一,大手町四丁目,158,320,156,164
2008,第一,大手町五丁目,114,270,132,138
2008,第一,本字出口町,36,93,46,47
2008,第一,幸町,52,128,65,63
2008,第一,本白銀町,152,291,137,154
2008,第一,白銀町,143,305,146,159
2008,第一,末広町,302,769,361,408
2008,第一,仲町,26,65,28,37
2008,第一,浅間町,13,35,17,18
2008,第一,魚町,10,34,17,17
2008,第一,通横町,6,14,5,9
2008,第一,鵰町,11,30,14,16
2008,第一,新町,4,9,6,3
2008,第一,添地町,178,350,155,195
2008,第一,西条町,194,424,210,214
2008,第一,上土町,128,276,138,138
2008,第一,本字仲町,4,11,5,6
2008,第一,本字浅間町,22,55,26,29
2008,第一,本字新町,11,31,14,17
2008,第一,本錦町,242,500,236,264
2008,第一,本丸子町,117,302,146,156
2008,第一,錦町,62,129,65,64
2008,第一,丸子町,6,13,5,8
2008,第一,八幡町,175,355,166,189
2008,第一,本町,41,80,43,37
2008,第一,下本町,49,98,48,50
2008,第一,大門町,31,82,37,45
2008,第一,真砂町,438,985,483,502
2008,第一,町方町,91,205,101,104
2008,第一,東宮後町,23,54,24,30
2008,第二,旭町,198,458,229,229
2008,第二,本字下小路町,95,210,104,106
2008,第二,本字宮町,87,225,109,116
2008,第二,市道町,338,772,352,420
2008,第二,春日町,72,180,96,84
2008,第二,蓼原町,67,207,97,110
2008,第二,蛇松町,87,217,100,117
2008,第二,本字下河原町,75,193,95,98
2008,第二,本字下河原街出口,76,194,97,97
2008,第二,下河原町,499,1210,584,626
2008,第二,本字下一丁田,144,319,145,174
2008,第二,本字前田,40,102,55,47
2008,第二,本字千本郷林,130,294,138,156
2008,第二,本字千本,66,153,75,78
2008,第二,本字千本,70,169,85,84
2008,第二,千本常盤町,67,135,57,78
2008,第二,常盤町一丁目,93,224,103,121
2008,第二,常盤町二丁目,43,100,44,56
2008,第二,常盤町三丁目,126,309,136,173
2008,第二,本松下,149,348,150,198
2008,第二,本西松下,70,182,87,95
2008,第二,本字松下七反田,86,198,96,102
2008,第二,松下町,15,41,23,18
2008,第二,千本緑町一丁目,89,211,87,124
2008,第二,千本緑町二丁目,41,90,37,53
2008,第二,千本緑町三丁目,61,131,60,71
2008,第二,千本港町,80,219,110,109
2008,第二,千本東町,75,163,77,86
2008,第二,千本西町,126,266,131,135
2008,第二,千本中町,60,177,83,94
2008,第三,我入道秋葉町,193,507,248,259
2008,第三,我入道外新田,1,4,2,2
2008,第三,下香貫石原,156,400,201,199
2008,第三,下香貫藤井原,240,551,285,266
2008,第三,下香貫矢丸,83,204,103,101
2008,第三,我入道稲荷町,139,356,175,181
2008,第三,下香貫牛臥,334,811,376,435
2008,第三,下香貫山宮前,35,93,46,47
2008,第三,我入道江川,173,438,212,226
2008,第三,我入道南条寺,245,615,303,312
2008,第三,香貫が丘,89,311,153,158
2008,第三,下香貫木ノ宮,380,1026,493,533
2008,第三,下香貫前角,68,155,74,81
2008,第三,下香貫猪沼,95,137,49,88
2008,第三,下香貫塩場,163,420,220,200
2008,第三,下香貫前原,118,291,133,158
2008,第三,下香貫浜田,217,571,293,278
2008,第三,下香貫善太夫,174,460,221,239
2008,第三,下香貫上障子,175,374,176,198
2008,第三,下香貫下障子,358,874,412,462
2008,第三,善太夫西原,5,16,8,8
2008,第三,下香貫外原,57,145,70,75
2008,第三,我入道津島町,76,191,101,90
2008,第三,下香貫島郷,392,981,487,494
2008,第三,下香貫塚田,179,464,232,232
2008,第三,下香貫大久保,249,662,293,369
2008,第三,下香貫柿原,185,452,217,235
2008,第三,下香貫清水,199,499,252,247
2008,第三,下香貫馬場,313,757,377,380
2008,第三,下香貫西村,130,294,150,144
2008,第三,下香貫上ノ原,128,316,146,170
2008,第三,下香貫給田,14,38,18,20
2008,第三,我入道浜町,106,285,138,147
2008,第三,我入道蔓陀ヶ原,37,84,40,44
2008,第三,我入道浜方,16,41,16,25
2008,第三,我入道林町,117,312,143,169
2008,第三,我入道東町,165,459,229,230
2008,第三,我入道一本松町,139,399,183,216
2008,第三,下香貫塩満,195,460,226,234
2008,第三,下香貫七面,90,232,127,105
2008,第三,下香貫林ノ下,229,609,311,298
2008,第三,下香貫汐入,235,525,279,246
2008,第三,下香貫樋ノ口,159,392,190,202
2008,第三,下香貫宮脇,386,986,475,511
2008,第三,下香貫宮原,44,99,48,51
2008,第三,下香貫八重,481,1143,557,586
2008,第三,下香貫八重原,5,13,8,5
2008,第三,下香貫楊原,438,1109,524,585
2008,第三,下香貫六反,8,16,6,10
2008,第四,市場町,318,708,345,363
2008,第四,上香貫大洞,1,4,2,2
2008,第四,上香貫仰天峰,18,46,24,22
2008,第四,上香貫長洞,6,11,6,5
2008,第四,上香貫東坂,7,12,5,7
2008,第四,上香貫蔓陀ヶ原,1,3,2,1
2008,第四,黒瀬町,45,127,63,64
2008,第四,西島町,613,1448,707,741
2008,第四,住吉町,236,575,284,291
2008,第四,三園町,431,973,511,462
2008,第四,玉江町,215,509,254,255
2008,第四,中瀬町,386,813,397,416
2008,第四,中原町,75,189,97,92
2008,第四,上香貫三貫地,211,579,294,285
2008,第四,上香貫東本郷町,13,17,10,7
2008,第四,上香貫二瀬川町,135,338,171,167
2008,第四,上香貫宮原町,202,462,211,251
2008,第四,上香貫獅子路,12,26,14,12
2008,第四,上香貫槙島町,102,225,108,117
2008,第四,上香貫一ノ洞,3,8,4,4
2008,第四,上香貫三ノ洞,5,11,6,5
2008,第四,上香貫九十九洞,20,55,28,27
2008,第四,上香貫坂口,5,7,3,4
2008,第四,上香貫手城山,4,5,2,3
2008,第四,山ヶ下町,13,35,19,16
2008,第四,上香貫八重,20,47,21,26
2008,第四,上香貫鉛山,2,2,1,1
2008,第四,本郷町,705,1680,779,901
2008,第四,上香貫三園町,31,83,41,42
2008,第四,南本郷町,328,783,369,414
2008,第四,上香貫南本郷町,14,36,17,19
2008,第四,御幸町,488,1150,554,596
2008,第四,吉田町,958,2124,1024,1100
2008,第五,泉町,271,678,343,335
2008,第五,庄栄町,395,941,440,501
2008,第五,山王台,390,864,417,447
2008,第五,三枚橋町,286,634,314,320
2008,第五,杉崎町,369,881,438,443
2008,第五,新宿町,755,1579,746,833
2008,第五,三枚橋杉崎町,1,7,4,3
2008,第五,平町,491,998,505,493
2008,第五,高島町,608,1200,590,610
2008,第五,高沢町,820,1755,885,870
2008,第五,高島本町,357,733,378,355
2008,第五,本字下中溝,7,18,9,9
2008,第五,三枚橋荒田,27,73,36,37
2008,第五,三枚橋竹ノ岬,56,162,80,82
2008,第五,日の出町,326,770,390,380
2008,第五,三枚橋日ノ出町,73,180,86,94
2008,第五,富士見町,243,485,263,222
2008,第五,双葉町,289,564,265,299
2008,第五,本田町,545,1210,615,595
2008,第五,三芳町,94,232,101,131
2008,第五,米山町,382,977,461,516
2008,大平,大平,1608,4426,2116,2310
2008,片浜,今沢,2207,4815,2277,2538
2008,片浜,大諏訪,1200,3059,1569,1490
2008,片浜,北今沢,329,902,456,446
2008,片浜,小諏訪,1071,2694,1319,1375
2008,片浜,西間門一丁目,0,0,0,0
2008,片浜,西間門二丁目,26,64,28,36
2008,片浜,西間門三丁目,17,45,21,24
2008,片浜,西間門,1284,3022,1521,1501
2008,片浜,東間門一丁目,9,24,11,13
2008,片浜,東間門二丁目,85,204,96,108
2008,片浜,東間門三丁目,66,160,79,81
2008,片浜,東間門,249,601,300,301
2008,片浜,松長,926,2323,1149,1174
2008,金岡,足高,592,1218,609,609
2008,金岡,共栄町,272,594,317,277
2008,金岡,江原町,458,1033,520,513
2008,金岡,神田町,413,912,501,411
2008,金岡,北園町,81,212,110,102
2008,金岡,寿町,614,1307,681,626
2008,金岡,沢田,13,43,26,17
2008,金岡,沢田町,114,301,145,156
2008,金岡,岡一色,1316,3370,1712,1658
2008,金岡,北高島町,429,954,484,470
2008,金岡,新沢田町,591,1398,712,686
2008,金岡,駿河台,392,966,497,469
2008,金岡,高尾台,223,542,295,247
2008,金岡,高砂町,323,812,411,401
2008,金岡,五月町,512,1143,569,574
2008,金岡,筒井町,158,366,182,184
2008,金岡,中沢田,611,1598,805,793
2008,金岡,西熊堂,420,1129,571,558
2008,金岡,西沢田,1367,3431,1761,1670
2008,金岡,沼北町一丁目,543,1208,641,567
2008,金岡,沼北町二丁目,369,946,479,467
2008,金岡,花園町,303,668,344,324
2008,金岡,東熊堂,548,1276,669,607
2008,金岡,東沢田,370,960,478,482
2008,金岡,宮前町,212,521,250,271
2008,金岡,松沢町,280,715,340,375
2008,金岡,緑ヶ丘,78,161,88,73
2008,金岡,岡宮,2238,5566,2777,2789
2008,金岡,柳町,481,1046,547,499
2008,金岡,豊町,300,833,412,421
2008,金岡,若葉町,638,1422,720,702
2008,大岡,大岡　石田ヶ丘,76,189,97,92
2008,大岡,大岡　駅前町,541,1255,618,637
2008,大岡,大岡　自由ヶ丘,440,909,437,472
2008,大岡,大岡　上石田,935,2267,1142,1125
2008,大岡,大岡　木瀬川,1374,3285,1652,1633
2008,大岡,大岡　平和郷,129,341,160,181
2008,大岡,大岡　北小林,405,1000,505,495
2008,大岡,小林台,121,317,158,159
2008,大岡,大岡　下石田,1814,4664,2256,2408
2008,大岡,大岡　仙岳町,76,223,111,112
2008,大岡,大岡　太田町,148,312,160,152
2008,大岡,大岡　高田,510,1035,558,477
2008,大岡,大岡　竹ノ岬,75,184,94,90
2008,大岡,大岡　駅前町,91,234,138,96
2008,大岡,大岡　中石田,1258,3012,1546,1466
2008,大岡,大岡　富岳町,86,150,58,92
2008,大岡,大岡　富士町,107,242,123,119
2008,大岡,大岡　沼平町,277,683,318,365
2008,大岡,大岡　南小林,1195,2946,1459,1487
2008,大岡,大岡　柏葉尾,270,618,286,332
2008,大岡,大岡　日吉,1509,3749,1859,1890
2008,大岡,大岡　大岡団地,242,460,209,251
2008,静浦,江浦,317,833,398,435
2008,静浦,口野,247,678,323,355
2008,静浦,志下,1121,2905,1466,1439
2008,静浦,獅子浜,409,1114,541,573
2008,静浦,多比,246,777,384,393
2008,静浦,馬込,211,580,288,292
2008,愛鷹,青野,761,2083,1084,999
2008,愛鷹,鳥谷,582,1615,830,785
2008,愛鷹,西椎路,1260,3338,1672,1666
2008,愛鷹,東原,914,2457,1220,1237
2008,愛鷹,東椎路,2505,6279,3103,3176
2008,愛鷹,宮本　富士通寮,23,23,23,0
2008,愛鷹,宮本,222,377,205,172
2008,愛鷹,柳沢,266,754,369,385
2008,内浦,内浦小海,117,344,174,170
2008,内浦,内浦重須,243,545,233,312
2008,内浦,内浦重寺,141,367,173,194
2008,内浦,内浦長浜,86,264,134,130
2008,内浦,内浦三津,272,780,374,406
2008,西浦,西浦足保,30,104,48,56
2008,西浦,西浦江梨,86,259,123,136
2008,西浦,西浦河内,61,220,97,123
2008,西浦,西浦木負,121,413,199,214
2008,西浦,西浦久連,105,375,188,187
2008,西浦,西浦久料,31,92,44,48
2008,西浦,西浦古宇,154,281,119,162
2008,西浦,西浦立保,49,169,79,90
2008,西浦,西浦平沢,36,137,63,74
2008,原,植田,182,494,249,245
2008,原,原　新田,503,1264,654,610
2008,原,西添町,539,1377,733,644
2008,原,大塚,2229,5433,2666,2767
2008,原,原　西町,796,2080,1024,1056
2008,原,原　東町,1669,4287,2121,2166
2008,原,原町中一丁目,126,377,193,184
2008,原,原町中二丁目,193,518,269,249
2008,原,原町中三丁目,368,1023,490,533
2008,原,一本松,310,810,397,413
2008,原,原　一本松,30,66,33,33
2008,原,桃里,492,1303,669,634
2008,原,原　六軒町,604,1682,825,857
2008,浮島,根古屋,715,1957,985,972
2008,浮島,井出,525,1486,715,771
2008,浮島,平沼,511,1168,592,576
2008,浮島,石川,560,1580,783,797
2008,戸田,井田,38,83,38,45
2008,戸田,戸田　入浜,179,438,226,212
2008,戸田,戸田　上野,97,248,118,130
2008,戸田,戸田　大浦,84,215,106,109
2008,戸田,戸田　大上,49,155,82,73
2008,戸田,戸田　奥南,50,121,56,65
2008,戸田,戸田　大中島,244,569,285,284
2008,戸田,戸田　鬼川,116,301,147,154
2008,戸田,戸田　小山田,86,203,106,97
2008,戸田,戸田　口南,47,112,52,60
2008,戸田,戸田　小中島,101,230,108,122
2008,戸田,戸田　一色,100,268,131,137
2008,戸田,戸田　新田,32,60,33,27
2008,戸田,戸田　大門,71,201,104,97
2008,戸田,戸田　中上,64,159,84,75
2008,戸田,戸田　平戸,66,188,92,96
2008,戸田,戸田　舟山,33,74,37,37
2008,戸田,戸田　御浜,63,133,65,68
2007,第一,大手町一丁目,121,242,123,119
2007,第一,大手町二丁目,188,349,181,168
2007,第一,大手町三丁目,100,214,108,106
2007,第一,大手町四丁目,128,274,128,146
2007,第一,大手町五丁目,109,277,133,144
2007,第一,本字出口町,40,101,48,53
2007,第一,幸町,51,127,65,62
2007,第一,本白銀町,153,298,137,161
2007,第一,白銀町,142,307,150,157
2007,第一,末広町,301,777,355,422
2007,第一,仲町,27,69,30,39
2007,第一,浅間町,10,28,14,14
2007,第一,魚町,12,38,18,20
2007,第一,通横町,6,17,8,9
2007,第一,鵰町,11,30,14,16
2007,第一,新町,5,12,8,4
2007,第一,添地町,180,360,164,196
2007,第一,西条町,200,441,218,223
2007,第一,上土町,129,272,139,133
2007,第一,本字仲町,4,11,5,6
2007,第一,本字浅間町,22,52,24,28
2007,第一,本字新町,11,33,15,18
2007,第一,本錦町,247,524,244,280
2007,第一,本丸子町,120,309,145,164
2007,第一,錦町,59,128,64,64
2007,第一,丸子町,5,10,3,7
2007,第一,八幡町,184,359,175,184
2007,第一,本町,41,74,43,31
2007,第一,下本町,47,91,45,46
2007,第一,大門町,31,82,38,44
2007,第一,真砂町,423,979,474,505
2007,第一,町方町,88,203,99,104
2007,第一,東宮後町,24,59,25,34
2007,第二,旭町,198,466,228,238
2007,第二,本字下小路町,94,218,106,112
2007,第二,本字宮町,94,238,115,123
2007,第二,市道町,345,793,362,431
2007,第二,春日町,76,191,100,91
2007,第二,蓼原町,66,205,96,109
2007,第二,蛇松町,86,213,101,112
2007,第二,本字下河原町,74,191,94,97
2007,第二,本字下河原街出口,72,196,98,98
2007,第二,下河原町,488,1205,578,627
2007,第二,本字下一丁田,157,338,158,180
2007,第二,本字前田,42,105,55,50
2007,第二,本字千本郷林,132,303,144,159
2007,第二,本字千本,72,161,79,82
2007,第二,本字千本,72,172,93,79
2007,第二,千本常盤町,68,138,58,80
2007,第二,常盤町一丁目,103,240,109,131
2007,第二,常盤町二丁目,42,101,48,53
2007,第二,常盤町三丁目,121,309,134,175
2007,第二,本松下,146,354,153,201
2007,第二,本西松下,74,179,88,91
2007,第二,本字松下七反田,84,201,97,104
2007,第二,松下町,17,44,24,20
2007,第二,千本緑町一丁目,89,205,88,117
2007,第二,千本緑町二丁目,43,94,40,54
2007,第二,千本緑町三丁目,54,118,53,65
2007,第二,千本港町,90,242,125,117
2007,第二,千本東町,73,159,76,83
2007,第二,千本西町,127,281,135,146
2007,第二,千本中町,61,179,84,95
2007,第三,我入道秋葉町,186,497,243,254
2007,第三,我入道外新田,1,4,2,2
2007,第三,下香貫石原,157,409,207,202
2007,第三,下香貫藤井原,229,539,281,258
2007,第三,下香貫矢丸,80,185,96,89
2007,第三,我入道稲荷町,137,352,179,173
2007,第三,下香貫牛臥,332,822,395,427
2007,第三,下香貫山宮前,34,90,47,43
2007,第三,我入道江川,169,427,209,218
2007,第三,我入道南条寺,252,617,301,316
2007,第三,香貫が丘,88,306,151,155
2007,第三,下香貫木ノ宮,383,1049,509,540
2007,第三,下香貫前角,64,154,72,82
2007,第三,下香貫猪沼,95,139,47,92
2007,第三,下香貫塩場,169,432,225,207
2007,第三,下香貫前原,116,282,129,153
2007,第三,下香貫浜田,220,579,297,282
2007,第三,下香貫善太夫,182,483,229,254
2007,第三,下香貫上障子,164,360,164,196
2007,第三,下香貫下障子,365,900,431,469
2007,第三,善太夫西原,5,16,8,8
2007,第三,下香貫外原,58,143,70,73
2007,第三,我入道津島町,78,193,101,92
2007,第三,下香貫島郷,383,987,491,496
2007,第三,下香貫塚田,182,481,240,241
2007,第三,下香貫大久保,254,682,304,378
2007,第三,下香貫柿原,183,439,218,221
2007,第三,下香貫清水,199,487,249,238
2007,第三,下香貫馬場,316,768,384,384
2007,第三,下香貫西村,133,316,158,158
2007,第三,下香貫上ノ原,128,317,144,173
2007,第三,下香貫給田,14,40,18,22
2007,第三,我入道浜町,110,293,142,151
2007,第三,我入道蔓陀ヶ原,37,83,40,43
2007,第三,我入道浜方,17,43,18,25
2007,第三,我入道林町,116,324,147,177
2007,第三,我入道東町,167,472,235,237
2007,第三,我入道一本松町,146,416,195,221
2007,第三,下香貫塩満,192,463,224,239
2007,第三,下香貫七面,82,224,123,101
2007,第三,下香貫林ノ下,218,588,301,287
2007,第三,下香貫汐入,243,557,289,268
2007,第三,下香貫樋ノ口,157,392,190,202
2007,第三,下香貫宮脇,375,977,466,511
2007,第三,下香貫宮原,47,108,51,57
2007,第三,下香貫八重,471,1123,551,572
2007,第三,下香貫八重原,4,13,8,5
2007,第三,下香貫楊原,434,1106,518,588
2007,第三,下香貫六反,9,17,6,11
2007,第四,市場町,296,689,327,362
2007,第四,上香貫大洞,1,4,2,2
2007,第四,上香貫仰天峰,17,44,23,21
2007,第四,上香貫長洞,5,10,5,5
2007,第四,上香貫東坂,7,12,5,7
2007,第四,上香蔓陀ヶ原,1,3,2,1
2007,第四,黒瀬町,45,133,66,67
2007,第四,西島町,598,1424,702,722
2007,第四,住吉町,240,563,279,284
2007,第四,三園町,426,951,485,466
2007,第四,玉江町,208,503,251,252
2007,第四,中瀬町,374,811,394,417
2007,第四,中原町,66,182,91,91
2007,第四,上香貫三貫地,220,597,310,287
2007,第四,上香貫東本郷町,11,13,7,6
2007,第四,上香貫二瀬川町,132,336,169,167
2007,第四,上香貫宮原町,217,494,227,267
2007,第四,上香貫獅子路,12,26,14,12
2007,第四,上香貫槙島町,103,218,106,112
2007,第四,上香貫一ノ洞,2,4,2,2
2007,第四,上香貫三ノ洞,5,10,5,5
2007,第四,上香貫九十九洞,20,58,30,28
2007,第四,上香貫坂口,5,7,3,4
2007,第四,上香貫手城山,4,5,2,3
2007,第四,山ヶ下町,13,34,19,15
2007,第四,上香貫八重,18,42,17,25
2007,第四,上香貫鉛山,3,4,2,2
2007,第四,本郷町,715,1702,785,917
2007,第四,上香貫三園町,34,94,47,47
2007,第四,南本郷町,324,795,373,422
2007,第四,上香貫南本郷町,15,39,20,19
2007,第四,御幸町,491,1152,557,595
2007,第四,吉田町,958,2141,1021,1120
2007,第五,泉町,287,718,361,357
2007,第五,庄栄町,399,942,438,504
2007,第五,山王台,385,864,427,437
2007,第五,三枚橋町,292,637,311,326
2007,第五,杉崎町,382,906,452,454
2007,第五,新宿町,752,1582,745,837
2007,第五,三枚橋杉崎町,1,7,4,3
2007,第五,平町,497,1014,519,495
2007,第五,高島町,568,1137,563,574
2007,第五,高沢町,798,1727,866,861
2007,第五,高島本町,376,797,415,382
2007,第五,本字下中溝,8,21,11,10
2007,第五,三枚橋荒田,26,70,34,36
2007,第五,三枚橋竹ノ岬,133,239,158,81
2007,第五,日の出町,317,767,379,388
2007,第五,三枚橋日ノ出町,72,167,80,87
2007,第五,富士見町,228,476,247,229
2007,第五,双葉町,284,564,268,296
2007,第五,本田町,547,1249,624,625
2007,第五,三芳町,93,226,96,130
2007,第五,米山町,361,930,444,486
2007,大平,大平,1602,4466,2145,2321
2007,片浜,今沢,2215,4910,2330,2580
2007,片浜,大諏訪,1176,3061,1550,1511
2007,片浜,北今沢,321,881,450,431
2007,片浜,小諏訪,1053,2712,1345,1367
2007,片浜,西間門一丁目,0,0,0,0
2007,片浜,西間門二丁目,27,70,31,39
2007,片浜,西間門三丁目,17,46,22,24
2007,片浜,西間門,1271,3011,1503,1508
2007,片浜,東間門一丁目,9,25,10,15
2007,片浜,東間門二丁目,84,200,94,106
2007,片浜,東間門三丁目,64,163,79,84
2007,片浜,東間門,248,583,294,289
2007,片浜,松長,915,2327,1152,1175
2007,金岡,足高,589,1227,610,617
2007,金岡,共栄町,274,603,321,282
2007,金岡,江原町,466,1052,531,521
2007,金岡,神田町,452,1024,571,453
2007,金岡,北園町,77,208,108,100
2007,金岡,寿町,589,1309,664,645
2007,金岡,沢田,13,44,27,17
2007,金岡,沢田町,113,297,145,152
2007,金岡,岡一色,1331,3443,1738,1705
2007,金岡,北高島町,437,957,482,475
2007,金岡,新沢田町,522,1200,609,591
2007,金岡,駿河台,398,970,492,478
2007,金岡,高尾台,217,538,282,256
2007,金岡,高砂町,331,836,428,408
2007,金岡,五月町,510,1164,592,572
2007,金岡,筒井町,157,379,190,189
2007,金岡,中沢田,599,1585,788,797
2007,金岡,西熊堂,410,1125,571,554
2007,金岡,西沢田,1414,3508,1795,1713
2007,金岡,沼北町一丁目,555,1222,636,586
2007,金岡,沼北町二丁目,368,929,472,457
2007,金岡,花園町,305,691,358,333
2007,金岡,東熊堂,532,1255,662,593
2007,金岡,東沢田,348,934,455,479
2007,金岡,宮前町,209,512,247,265
2007,金岡,松沢町,277,715,342,373
2007,金岡,緑ヶ丘,67,134,76,58
2007,金岡,岡宮,2146,5421,2709,2712
2007,金岡,柳町,464,1028,535,493
2007,金岡,豊町,293,829,408,421
2007,金岡,若葉町,632,1427,722,705
2007,大岡,大岡　石田ヶ丘,77,186,93,93
2007,大岡,大岡　駅前町,548,1287,638,649
2007,大岡,大岡　自由ヶ丘,441,934,453,481
2007,大岡,大岡　上石田,889,2177,1082,1095
2007,大岡,大岡　木瀬川,1370,3273,1654,1619
2007,大岡,大岡　平和郷,127,344,160,184
2007,大岡,大岡　北小林,401,1023,519,504
2007,大岡,小林台,126,330,166,164
2007,大岡,大岡　下石田,1807,4700,2274,2426
2007,大岡,大岡　仙岳町,83,238,118,120
2007,大岡,大岡　太田町,145,303,156,147
2007,大岡,大岡　高田,427,955,474,481
2007,大岡,大岡　竹ノ岬,72,183,90,93
2007,大岡,大岡　駅前町,96,256,148,108
2007,大岡,大岡　中石田,1264,3080,1554,1526
2007,大岡,大岡　富岳町,90,160,62,98
2007,大岡,大岡　富士町,105,243,126,117
2007,大岡,大岡　沼平町,284,691,327,364
2007,大岡,大岡　南小林,1154,2898,1449,1449
2007,大岡,大岡　柏葉尾,276,621,287,334
2007,大岡,大岡　日吉,1471,3700,1830,1870
2007,大岡,大岡　大岡団地,244,476,215,261
2007,静浦,江浦,317,860,402,458
2007,静浦,口野,247,693,332,361
2007,静浦,志下,1121,2943,1473,1470
2007,静浦,獅子浜,406,1139,556,583
2007,静浦,多比,245,786,390,396
2007,静浦,馬込,211,592,293,299
2007,愛鷹,青野,737,2080,1077,1003
2007,愛鷹,鳥谷,581,1618,833,785
2007,愛鷹,西椎路,1222,3269,1643,1626
2007,愛鷹,東原,905,2464,1226,1238
2007,愛鷹,東椎路,2483,6308,3112,3196
2007,愛鷹,宮本　富士通寮,10,10,10,0
2007,愛鷹,宮本,232,389,211,178
2007,愛鷹,柳沢,260,734,360,374
2007,内浦,内浦小海,118,360,183,177
2007,内浦,内浦重須,240,550,237,313
2007,内浦,内浦重寺,141,376,178,198
2007,内浦,内浦長浜,83,268,135,133
2007,内浦,内浦三津,281,808,386,422
2007,西浦,西浦足保,30,105,49,56
2007,西浦,西浦江梨,86,259,124,135
2007,西浦,西浦河内,63,231,102,129
2007,西浦,西浦木負,120,421,205,216
2007,西浦,西浦久連,105,379,191,188
2007,西浦,西浦久料,32,92,45,47
2007,西浦,西浦古宇,155,286,121,165
2007,西浦,西浦立保,49,172,80,92
2007,西浦,西浦平沢,37,147,68,79
2007,原,植田,185,501,255,246
2007,原,原　新田,509,1303,665,638
2007,原,西添町,536,1399,734,665
2007,原,大塚,2180,5519,2718,2801
2007,原,原　西町,790,2095,1035,1060
2007,原,原　東町,1643,4269,2100,2169
2007,原,原町中一丁目,122,345,177,168
2007,原,原町中二丁目,199,541,279,262
2007,原,原町中三丁目,363,1017,484,533
2007,原,一本松,315,829,410,419
2007,原,原　一本松,28,61,31,30
2007,原,桃里,488,1329,677,652
2007,原,原　六軒町,601,1653,812,841
2007,浮島,根古屋,706,1960,976,984
2007,浮島,井出,522,1501,721,780
2007,浮島,平沼,504,1199,615,584
2007,浮島,石川,550,1562,778,784
2007,戸田,井田,40,89,41,48
2007,戸田,戸田　入浜,181,444,230,214
2007,戸田,戸田　上野,92,240,116,124
2007,戸田,戸田　大浦,83,224,107,117
2007,戸田,戸田　大上,51,154,81,73
2007,戸田,戸田　奥南,51,121,54,67
2007,戸田,戸田　大中島,242,569,284,285
2007,戸田,戸田　鬼川,118,305,150,155
2007,戸田,戸田　小山田,83,203,106,97
2007,戸田,戸田　口南,47,110,50,60
2007,戸田,戸田　小中島,102,234,110,124
2007,戸田,戸田　一色,98,268,133,135
2007,戸田,戸田　新田,31,65,36,29
2007,戸田,戸田　大門,73,207,110,97
2007,戸田,戸田　中上,66,171,88,83
2007,戸田,戸田　平戸,66,190,95,95
2007,戸田,戸田　舟山,31,72,36,36
2007,戸田,戸田　御浜,62,133,66,67
2006,第一,大手町一丁目,48,81,41,40
2006,第一,大手町二丁目,190,362,180,182
2006,第一,大手町三丁目,83,179,94,85
2006,第一,大手町四丁目,134,282,133,149
2006,第一,大手町五丁目,113,286,136,150
2006,第一,本字出口町,37,97,49,48
2006,第一,幸町,53,135,66,69
2006,第一,本白銀町,147,303,137,166
2006,第一,白銀町,137,299,144,155
2006,第一,末広町,291,752,349,403
2006,第一,仲町,26,68,31,37
2006,第一,浅間町,10,27,13,14
2006,第一,魚町,12,39,19,20
2006,第一,通横町,7,18,8,10
2006,第一,鵰町,9,26,12,14
2006,第一,新町,5,11,7,4
2006,第一,添地町,183,369,169,200
2006,第一,西条町,202,446,220,226
2006,第一,上土町,130,286,145,141
2006,第一,本字仲町,3,6,3,3
2006,第一,本字浅間町,23,53,25,28
2006,第一,本字新町,11,30,15,15
2006,第一,本錦町,249,537,246,291
2006,第一,本丸子町,120,306,145,161
2006,第一,錦町,58,134,65,69
2006,第一,丸子町,5,10,3,7
2006,第一,八幡町,171,359,171,188
2006,第一,本町,43,81,46,35
2006,第一,下本町,45,87,44,43
2006,第一,大門町,31,83,39,44
2006,第一,真砂町,426,991,483,508
2006,第一,町方町,90,206,97,109
2006,第一,東宮後町,24,64,26,38
2006,第二,旭町,191,466,234,232
2006,第二,本字下小路町,93,217,104,113
2006,第二,本字宮町,89,234,116,118
2006,第二,市道町,348,808,367,441
2006,第二,春日町,81,200,106,94
2006,第二,蓼原町,65,202,98,104
2006,第二,蛇松町,90,222,107,115
2006,第二,本字下河原町,78,202,97,105
2006,第二,本字下河原街出口,74,206,103,103
2006,第二,下河原町,492,1212,580,632
2006,第二,本字下一丁田,159,347,160,187
2006,第二,本字前田,40,104,55,49
2006,第二,本字千本郷林,131,302,145,157
2006,第二,本字千本,80,184,91,93
2006,第二,本字千本,68,170,88,82
2006,第二,千本常盤町,74,147,65,82
2006,第二,常盤町一丁目,102,239,110,129
2006,第二,常盤町二丁目,40,100,46,54
2006,第二,常盤町三丁目,120,316,140,176
2006,第二,本松下,150,366,160,206
2006,第二,本西松下,67,173,80,93
2006,第二,本字松下七反田,89,200,98,102
2006,第二,松下町,18,46,25,21
2006,第二,千本緑町一丁目,92,209,89,120
2006,第二,千本緑町二丁目,42,91,39,52
2006,第二,千本緑町三丁目,62,128,60,68
2006,第二,千本港町,93,237,123,114
2006,第二,千本東町,72,163,78,85
2006,第二,千本西町,126,277,135,142
2006,第二,千本中町,57,173,81,92
2006,第三,我入道秋葉町,187,512,249,263
2006,第三,我入道外新田,1,6,3,3
2006,第三,下香貫石原,150,411,206,205
2006,第三,下香貫藤井原,231,544,282,262
2006,第三,下香貫矢丸,79,190,95,95
2006,第三,我入道稲荷町,136,356,182,174
2006,第三,下香貫牛臥,329,829,401,428
2006,第三,下香貫山宮前,36,98,50,48
2006,第三,我入道江川,162,413,204,209
2006,第三,我入道南条寺,243,615,305,310
2006,第三,香貫が丘,89,312,155,157
2006,第三,下香貫木ノ宮,372,1032,501,531
2006,第三,下香貫前角,66,161,76,85
2006,第三,下香貫猪沼,98,148,53,95
2006,第三,下香貫塩場,159,415,213,202
2006,第三,下香貫前原,117,296,133,163
2006,第三,下香貫浜田,221,586,305,281
2006,第三,下香貫善太夫,183,492,230,262
2006,第三,下香貫上障子,157,345,155,190
2006,第三,下香貫下障子,386,944,452,492
2006,第三,善太夫西原,6,19,10,9
2006,第三,下香貫外原,57,152,70,82
2006,第三,我入道津島町,78,199,107,92
2006,第三,下香貫島郷,378,977,483,494
2006,第三,下香貫塚田,182,470,240,230
2006,第三,下香貫大久保,250,687,312,375
2006,第三,下香貫柿原,187,454,226,228
2006,第三,下香貫清水,207,512,260,252
2006,第三,下香貫馬場,317,778,389,389
2006,第三,下香貫西村,135,322,158,164
2006,第三,下香貫上ノ原,128,325,150,173
2006,第三,下香貫給田,14,40,17,23
2006,第三,我入道浜町,112,296,141,155
2006,第三,我入道蔓陀ヶ原,41,90,43,47
2006,第三,我入道浜方,17,43,18,25
2006,第三,我入道林町,114,322,146,176
2006,第三,我入道東町,164,477,240,237
2006,第三,我入道一本松町,147,426,204,222
2006,第三,下香貫塩満,187,465,225,240
2006,第三,下香貫七面,86,230,125,105
2006,第三,下香貫林ノ下,214,589,299,290
2006,第三,下香貫汐入,229,531,279,252
2006,第三,下香貫樋ノ口,158,394,196,198
2006,第三,下香貫宮脇,377,976,463,513
2006,第三,下香貫宮原,49,113,54,59
2006,第三,下香貫八重,472,1132,559,573
2006,第三,下香貫八重原,4,13,8,5
2006,第三,下香貫楊原,410,1058,509,549
2006,第三,下香貫六反,9,15,6,9
2006,第四,市場町,289,678,321,357
2006,第四,上香貫大洞,1,4,2,2
2006,第四,上香貫仰天峰,17,48,26,22
2006,第四,上香貫長洞,5,10,5,5
2006,第四,上香貫東坂,7,12,5,7
2006,第四,上香蔓陀ヶ原,1,3,2,1
2006,第四,黒瀬町,44,132,63,69
2006,第四,西島町,567,1370,675,695
2006,第四,住吉町,245,576,282,294
2006,第四,三園町,436,949,488,461
2006,第四,玉江町,212,525,264,261
2006,第四,中瀬町,377,819,400,419
2006,第四,中原町,63,171,85,86
2006,第四,上香貫三貫地,210,589,307,282
2006,第四,上香貫東本郷町,10,13,7,6
2006,第四,上香貫二瀬川町,133,346,173,173
2006,第四,上香貫宮原町,226,515,232,283
2006,第四,上香貫獅子路,12,26,14,12
2006,第四,上香貫槙島町,89,201,96,105
2006,第四,上香貫一ノ洞,2,5,3,2
2006,第四,上香貫三ノ洞,5,10,5,5
2006,第四,上香貫九十九洞,20,59,31,28
2006,第四,上香貫坂口,4,7,2,5
2006,第四,上香貫手城山,4,5,2,3
2006,第四,山ヶ下町,13,35,19,16
2006,第四,上香貫八重,20,47,21,26
2006,第四,上香貫鉛山,3,4,2,2
2006,第四,本郷町,716,1734,797,937
2006,第四,上香貫三園町,36,95,50,45
2006,第四,南本郷町,323,802,381,421
2006,第四,上香貫南本郷町,15,43,20,23
2006,第四,御幸町,484,1162,554,608
2006,第四,吉田町,932,2166,1011,1155
2006,第五,泉町,298,738,370,368
2006,第五,庄栄町,395,946,432,514
2006,第五,山王台,382,860,423,437
2006,第五,三枚橋町,270,570,282,288
2006,第五,杉崎町,389,929,453,476
2006,第五,新宿町,738,1589,751,838
2006,第五,三枚橋杉崎町,1,7,4,3
2006,第五,平町,497,1013,524,489
2006,第五,高島町,579,1153,577,576
2006,第五,高沢町,811,1749,883,866
2006,第五,高島本町,381,825,424,401
2006,第五,本字下中溝,11,25,14,11
2006,第五,三枚橋荒田,27,73,39,34
2006,第五,三枚橋竹ノ岬,135,240,157,83
2006,第五,日の出町,319,787,385,402
2006,第五,三枚橋日ノ出町,77,175,82,93
2006,第五,富士見町,259,532,275,257
2006,第五,双葉町,285,568,274,294
2006,第五,本田町,539,1236,622,614
2006,第五,三芳町,91,221,93,128
2006,第五,米山町,377,964,463,501
2006,大平,大平,1584,4476,2148,2328
2006,片浜,今沢,2211,4990,2379,2611
2006,片浜,大諏訪,1149,3035,1545,1490
2006,片浜,北今沢,319,882,456,426
2006,片浜,小諏訪,1059,2754,1368,1386
2006,片浜,西間門一丁目,1,1,1,0
2006,片浜,西間門二丁目,25,68,32,36
2006,片浜,西間門三丁目,16,42,21,21
2006,片浜,西間門,1258,3041,1512,1529
2006,片浜,東間門一丁目,11,28,11,17
2006,片浜,東間門二丁目,92,212,102,110
2006,片浜,東間門三丁目,63,164,81,83
2006,片浜,東間門,254,592,302,290
2006,片浜,松長,887,2292,1140,1152
2006,金岡,足高,587,1228,600,628
2006,金岡,共栄町,266,576,303,273
2006,金岡,江原町,462,1040,523,517
2006,金岡,神田町,436,1010,559,451
2006,金岡,北園町,76,203,106,97
2006,金岡,寿町,584,1324,659,665
2006,金岡,沢田,13,45,27,18
2006,金岡,沢田町,115,304,149,155
2006,金岡,岡一色,1298,3421,1710,1711
2006,金岡,北高島町,434,959,481,478
2006,金岡,新沢田町,499,1140,580,560
2006,金岡,駿河台,402,990,502,488
2006,金岡,高尾台,218,551,284,267
2006,金岡,高砂町,319,814,416,398
2006,金岡,五月町,510,1175,599,576
2006,金岡,筒井町,157,382,186,196
2006,金岡,中沢田,575,1567,797,770
2006,金岡,西熊堂,402,1138,581,557
2006,金岡,西沢田,1361,3373,1727,1646
2006,金岡,沼北町一丁目,540,1191,633,558
2006,金岡,沼北町二丁目,367,927,470,457
2006,金岡,花園町,295,684,342,342
2006,金岡,東熊堂,540,1297,678,619
2006,金岡,東沢田,338,940,456,484
2006,金岡,宮前町,187,453,221,232
2006,金岡,松沢町,281,733,360,373
2006,金岡,緑ヶ丘,68,140,77,63
2006,金岡,岡宮,2109,5341,2682,2659
2006,金岡,柳町,481,1058,551,507
2006,金岡,豊町,297,845,419,426
2006,金岡,若葉町,602,1372,694,678
2006,大岡,大岡　石田ヶ丘,79,192,95,97
2006,大岡,大岡　駅前町,536,1298,641,657
2006,大岡,大岡　自由ヶ丘,457,951,459,492
2006,大岡,大岡　上石田,872,2180,1086,1094
2006,大岡,大岡　木瀬川,1328,3244,1639,1605
2006,大岡,大岡　平和郷,129,347,161,186
2006,大岡,大岡　北小林,404,1041,536,505
2006,大岡,小林台,121,314,159,155
2006,大岡,大岡　下石田,1760,4629,2251,2378
2006,大岡,大岡　仙岳町,90,260,131,129
2006,大岡,大岡　太田町,100,201,108,93
2006,大岡,大岡　高田,420,956,479,477
2006,大岡,大岡　竹ノ岬,77,192,96,96
2006,大岡,大岡　駅前町,86,248,139,109
2006,大岡,大岡　中石田,1266,3089,1566,1523
2006,大岡,大岡　富岳町,88,165,63,102
2006,大岡,大岡　富士町,106,250,130,120
2006,大岡,大岡　沼平町,280,692,325,367
2006,大岡,大岡　南小林,1174,2952,1480,1472
2006,大岡,大岡　柏葉尾,273,614,279,335
2006,大岡,大岡　日吉,1483,3774,1863,1911
2006,大岡,大岡　大岡団地,244,485,223,262
2006,静浦,江浦,323,897,422,475
2006,静浦,口野,241,692,334,358
2006,静浦,志下,1108,2970,1490,1480
2006,静浦,獅子浜,417,1181,571,610
2006,静浦,多比,244,800,397,403
2006,静浦,馬込,214,610,304,306
2006,愛鷹,青野,718,2085,1071,1014
2006,愛鷹,鳥谷,580,1641,843,798
2006,愛鷹,西椎路,1195,3251,1655,1596
2006,愛鷹,東原,911,2489,1242,1247
2006,愛鷹,東椎路,2459,6342,3124,3218
2006,愛鷹,宮本　富士通寮,11,11,11,0
2006,愛鷹,宮本,204,365,194,171
2006,愛鷹,柳沢,261,748,366,382
2006,内浦,内浦小海,114,361,185,176
2006,内浦,内浦重須,237,558,242,316
2006,内浦,内浦重寺,136,372,179,193
2006,内浦,内浦長浜,84,279,137,142
2006,内浦,内浦三津,280,811,385,428
2006,西浦,西浦足保,29,106,49,57
2006,西浦,西浦江梨,82,265,128,137
2006,西浦,西浦河内,65,237,105,132
2006,西浦,西浦木負,120,424,203,221
2006,西浦,西浦久連,106,388,198,190
2006,西浦,西浦久料,31,95,46,49
2006,西浦,西浦古宇,154,285,121,164
2006,西浦,西浦立保,49,183,83,100
2006,西浦,西浦平沢,37,148,69,79
2006,原,植田,174,483,244,239
2006,原,原　新田,502,1306,669,637
2006,原,西添町,529,1398,728,670
2006,原,大塚,2187,5668,2779,2889
2006,原,原　西町,801,2130,1056,1074
2006,原,原　東町,1627,4269,2103,2166
2006,原,原町中一丁目,108,317,166,151
2006,原,原町中二丁目,170,486,253,233
2006,原,原町中三丁目,357,1034,482,552
2006,原,一本松,330,855,434,421
2006,原,原　一本松,29,64,33,31
2006,原,桃里,492,1331,675,656
2006,原,原　六軒町,598,1683,839,844
2006,浮島,根古屋,687,1953,978,975
2006,浮島,井出,521,1525,732,793
2006,浮島,平沼,509,1208,625,583
2006,浮島,石川,533,1537,759,778
2006,戸田,井田,39,91,41,50
2006,戸田,戸田　入浜,183,455,231,224
2006,戸田,戸田　上野,92,253,118,135
2006,戸田,戸田　大浦,83,227,114,113
2006,戸田,戸田　大上,50,160,82,78
2006,戸田,戸田　奥南,52,127,59,68
2006,戸田,戸田　大中島,241,587,295,292
2006,戸田,戸田　鬼川,119,310,151,159
2006,戸田,戸田　小山田,84,209,112,97
2006,戸田,戸田　口南,48,113,49,64
2006,戸田,戸田　小中島,99,230,108,122
2006,戸田,戸田　一色,99,278,140,138
2006,戸田,戸田　新田,31,65,36,29
2006,戸田,戸田　大門,71,213,111,102
2006,戸田,戸田　中上,66,174,89,85
2006,戸田,戸田　平戸,66,192,91,101
2006,戸田,戸田　舟山,33,78,41,37
2006,戸田,戸田　御浜,63,136,71,65
2005,第一,大手町一丁目,49,81,41,40
2005,第一,大手町二丁目,184,356,173,183
2005,第一,大手町三丁目,45,100,51,49
2005,第一,大手町四丁目,117,262,124,138
2005,第一,大手町五丁目,118,300,152,148
2005,第一,本字出口町,41,106,52,54
2005,第一,幸町,57,143,71,72
2005,第一,本白銀町,154,318,142,176
2005,第一,白銀町,104,239,113,126
2005,第一,末広町,288,747,340,407
2005,第一,仲町,26,72,34,38
2005,第一,浅間町,10,27,13,14
2005,第一,魚町,13,43,23,20
2005,第一,通横町,7,18,8,10
2005,第一,鵰町,9,26,12,14
2005,第一,新町,5,11,7,4
2005,第一,添地町,187,379,174,205
2005,第一,西条町,190,437,211,226
2005,第一,上土町,121,271,135,136
2005,第一,本字仲町,3,8,5,3
2005,第一,本字浅間町,24,56,26,30
2005,第一,本字新町,10,29,15,14
2005,第一,本錦町,255,550,253,297
2005,第一,本丸子町,123,313,152,161
2005,第一,錦町,55,133,64,69
2005,第一,丸子町,6,11,2,9
2005,第一,八幡町,175,362,169,193
2005,第一,本町,43,82,48,34
2005,第一,下本町,47,89,48,41
2005,第一,大門町,31,79,37,42
2005,第一,真砂町,431,997,488,509
2005,第一,町方町,81,196,87,109
2005,第一,東宮後町,24,62,25,37
2005,第二,旭町,185,469,237,232
2005,第二,本字下小路町,90,208,97,111
2005,第二,本字宮町,87,231,115,116
2005,第二,市道町,358,852,383,469
2005,第二,春日町,83,209,109,100
2005,第二,蓼原町,69,220,107,113
2005,第二,蛇松町,89,222,106,116
2005,第二,本字下河原町,79,209,100,109
2005,第二,本字下河原街出口,75,204,105,99
2005,第二,下河原町,483,1220,580,640
2005,第二,本字下一丁田,162,351,160,191
2005,第二,本字前田,43,114,61,53
2005,第二,本字千本郷林,128,302,148,154
2005,第二,本字千本,81,197,97,100
2005,第二,本字千本,64,166,87,79
2005,第二,千本常盤町,69,136,63,73
2005,第二,常盤町一丁目,106,242,112,130
2005,第二,常盤町二丁目,43,108,51,57
2005,第二,常盤町三丁目,117,315,142,173
2005,第二,本松下,144,359,157,202
2005,第二,本西松下,71,186,89,97
2005,第二,本字松下七反田,87,198,99,99
2005,第二,松下町,18,45,24,21
2005,第二,千本緑町一丁目,90,208,87,121
2005,第二,千本緑町二丁目,41,90,39,51
2005,第二,千本緑町三丁目,70,146,69,77
2005,第二,千本港町,89,232,117,115
2005,第二,千本東町,69,168,79,89
2005,第二,千本西町,131,289,144,145
2005,第二,千本中町,58,178,84,94
2005,第三,我入道秋葉町,191,520,256,264
2005,第三,我入道外新田,1,6,3,3
2005,第三,下香貫石原,152,421,213,208
2005,第三,下香貫藤井原,222,540,283,257
2005,第三,下香貫矢丸,73,183,92,91
2005,第三,我入道稲荷町,141,379,192,187
2005,第三,下香貫牛臥,334,842,411,431
2005,第三,下香貫山宮前,35,101,50,51
2005,第三,我入道江川,163,424,205,219
2005,第三,我入道南条寺,230,605,290,315
2005,第三,香貫が丘,82,302,152,150
2005,第三,下香貫木ノ宮,370,1043,511,532
2005,第三,下香貫前角,59,151,71,80
2005,第三,下香貫猪沼,97,149,52,97
2005,第三,下香貫塩場,163,416,214,202
2005,第三,下香貫前原,120,292,132,160
2005,第三,下香貫浜田,206,558,289,269
2005,第三,下香貫善太夫,177,487,228,259
2005,第三,下香貫上障子,162,365,167,198
2005,第三,下香貫下障子,381,944,450,494
2005,第三,善太夫西原,6,19,10,9
2005,第三,下香貫外原,55,151,68,83
2005,第三,我入道津島町,75,196,107,89
2005,第三,下香貫島郷,388,1020,503,517
2005,第三,下香貫塚田,183,483,248,235
2005,第三,下香貫大久保,252,696,323,373
2005,第三,下香貫柿原,176,439,215,224
2005,第三,下香貫清水,206,511,262,249
2005,第三,下香貫馬場,316,780,388,392
2005,第三,下香貫西村,136,328,166,162
2005,第三,下香貫上ノ原,127,330,158,172
2005,第三,下香貫給田,14,40,18,22
2005,第三,我入道浜町,116,308,146,162
2005,第三,我入道蔓陀ヶ原,45,103,50,53
2005,第三,我入道浜方,17,44,18,26
2005,第三,我入道林町,109,334,154,180
2005,第三,我入道東町,161,478,243,235
2005,第三,我入道一本松町,143,432,204,228
2005,第三,下香貫塩満,170,456,224,232
2005,第三,下香貫七面,87,234,127,107
2005,第三,下香貫林ノ下,210,590,300,290
2005,第三,下香貫汐入,229,534,275,259
2005,第三,下香貫樋ノ口,153,400,200,200
2005,第三,下香貫宮脇,378,996,478,518
2005,第三,下香貫宮原,51,121,57,64
2005,第三,下香貫八重,455,1114,544,570
2005,第三,下香貫八重原,4,14,9,5
2005,第三,下香貫楊原,395,1039,498,541
2005,第三,下香貫六反,9,15,6,9
2005,第四,市場町,301,698,338,360
2005,第四,上香貫大洞,1,4,2,2
2005,第四,上香貫仰天峰,17,50,28,22
2005,第四,上香貫長洞,5,10,5,5
2005,第四,上香貫東坂,6,11,4,7
2005,第四,上香蔓陀ヶ原,1,3,2,1
2005,第四,黒瀬町,47,142,68,74
2005,第四,西島町,541,1337,654,683
2005,第四,住吉町,242,569,280,289
2005,第四,三園町,422,916,468,448
2005,第四,玉江町,199,509,255,254
2005,第四,中瀬町,378,823,399,424
2005,第四,中原町,66,181,90,91
2005,第四,上香貫三貫地,212,585,304,281
2005,第四,上香貫東本郷町,10,13,7,6
2005,第四,上香貫二瀬川町,133,353,175,178
2005,第四,上香貫宮原町,211,487,226,261
2005,第四,上香貫獅子路,12,26,14,12
2005,第四,上香貫槙島町,89,201,100,101
2005,第四,上香貫一ノ洞,2,5,3,2
2005,第四,上香貫三ノ洞,5,11,6,5
2005,第四,上香貫九十九洞,20,59,30,29
2005,第四,上香貫坂口,4,7,2,5
2005,第四,上香貫手城山,4,5,2,3
2005,第四,山ヶ下町,13,36,19,17
2005,第四,上香貫八重,20,49,23,26
2005,第四,上香貫鉛山,3,4,2,2
2005,第四,本郷町,723,1762,815,947
2005,第四,上香貫三園町,43,104,59,45
2005,第四,南本郷町,319,809,384,425
2005,第四,上香貫南本郷町,15,39,17,22
2005,第四,御幸町,469,1137,539,598
2005,第四,吉田町,930,2169,1023,1146
2005,第五,泉町,315,774,390,384
2005,第五,庄栄町,388,924,431,493
2005,第五,山王台,385,869,423,446
2005,第五,三枚橋町,256,557,266,291
2005,第五,杉崎町,371,899,438,461
2005,第五,新宿町,724,1585,740,845
2005,第五,三枚橋杉崎町,1,7,4,3
2005,第五,平町,479,1008,520,488
2005,第五,高島町,574,1164,588,576
2005,第五,高沢町,820,1757,881,876
2005,第五,高島本町,396,843,430,413
2005,第五,本字下中溝,13,28,16,12
2005,第五,三枚橋荒田,25,71,37,34
2005,第五,三枚橋竹ノ岬,124,231,148,83
2005,第五,日の出町,315,815,396,419
2005,第五,三枚橋日ノ出町,68,162,75,87
2005,第五,富士見町,270,549,286,263
2005,第五,双葉町,277,561,274,287
2005,第五,本田町,553,1276,641,635
2005,第五,三芳町,97,239,102,137
2005,第五,米山町,390,1000,483,517
2005,大平,大平,1588,4552,2179,2373
2005,片浜,今沢,2199,5034,2404,2630
2005,片浜,大諏訪,1127,3019,1540,1479
2005,片浜,北今沢,308,844,435,409
2005,片浜,小諏訪,1032,2740,1368,1372
2005,片浜,西間門二丁目,25,71,34,37
2005,片浜,西間門三丁目,17,49,24,25
2005,片浜,西間門,1263,3098,1541,1557
2005,片浜,東間門一丁目,11,28,11,17
2005,片浜,東間門二丁目,89,211,94,117
2005,片浜,東間門三丁目,60,164,81,83
2005,片浜,東間門,252,571,284,287
2005,片浜,松長,845,2230,1095,1135
2005,金岡,足高,582,1213,609,604
2005,金岡,共栄町,277,601,313,288
2005,金岡,江原町,463,1071,524,547
2005,金岡,神田町,440,1026,567,459
2005,金岡,北園町,81,220,112,108
2005,金岡,寿町,580,1299,647,652
2005,金岡,沢田,12,43,27,16
2005,金岡,沢田町,116,315,154,161
2005,金岡,岡一色,1269,3343,1688,1655
2005,金岡,北高島町,440,972,486,486
2005,金岡,新沢田町,489,1130,580,550
2005,金岡,駿河台,393,966,493,473
2005,金岡,高尾台,219,564,290,274
2005,金岡,高砂町,307,814,416,398
2005,金岡,五月町,509,1181,614,567
2005,金岡,筒井町,147,354,172,182
2005,金岡,中沢田,577,1579,798,781
2005,金岡,西熊堂,392,1123,571,552
2005,金岡,西沢田,1346,3407,1730,1677
2005,金岡,沼北町一丁目,551,1253,662,591
2005,金岡,沼北町二丁目,374,922,474,448
2005,金岡,花園町,297,709,350,359
2005,金岡,東熊堂,539,1321,681,640
2005,金岡,東沢田,326,904,441,463
2005,金岡,宮前町,189,451,213,238
2005,金岡,松沢町,280,744,364,380
2005,金岡,緑ヶ丘,74,146,78,68
2005,金岡,岡宮,2064,5250,2656,2594
2005,金岡,柳町,487,1054,552,502
2005,金岡,豊町,294,851,424,427
2005,金岡,若葉町,578,1300,667,633
2005,大岡,大岡　石田ヶ丘,79,188,94,94
2005,大岡,大岡　駅前町,514,1253,615,638
2005,大岡,大岡　自由ヶ丘,447,938,444,494
2005,大岡,大岡　上石田,866,2157,1081,1076
2005,大岡,大岡　木瀬川,1334,3267,1654,1613
2005,大岡,大岡　平和郷,132,351,169,182
2005,大岡,大岡　北小林,407,1051,534,517
2005,大岡,小林台,117,309,155,154
2005,大岡,大岡　下石田,1755,4640,2263,2377
2005,大岡,大岡　仙岳町,103,279,141,138
2005,大岡,大岡　太田町,87,189,100,89
2005,大岡,大岡　高田,419,979,494,485
2005,大岡,大岡　竹ノ岬,75,183,91,92
2005,大岡,大岡　駅前町,93,250,137,113
2005,大岡,大岡　中石田,1241,3006,1551,1455
2005,大岡,大岡　富岳町,92,174,68,106
2005,大岡,大岡　富士町,112,252,135,117
2005,大岡,大岡　沼平町,279,691,328,363
2005,大岡,大岡　南小林,1162,2952,1486,1466
2005,大岡,大岡　柏葉尾,270,611,275,336
2005,大岡,大岡　日吉,1473,3796,1875,1921
2005,大岡,大岡　大岡団地,245,486,221,265
2005,静浦,江浦,331,921,435,486
2005,静浦,口野,249,717,346,371
2005,静浦,志下,1103,3010,1521,1489
2005,静浦,獅子浜,420,1212,585,627
2005,静浦,多比,246,817,406,411
2005,静浦,馬込,214,617,310,307
2005,愛鷹,青野,718,2124,1073,1051
2005,愛鷹,鳥谷,576,1638,846,792
2005,愛鷹,西椎路,1199,3289,1660,1629
2005,愛鷹,東原,888,2446,1203,1243
2005,愛鷹,東椎路,2435,6349,3140,3209
2005,愛鷹,宮本　富士通寮,19,19,19,0
2005,愛鷹,宮本,142,305,149,156
2005,愛鷹,柳沢,259,736,353,383
2005,内浦,内浦小海,110,362,183,179
2005,内浦,内浦重須,236,561,241,320
2005,内浦,内浦重寺,138,380,184,196
2005,内浦,内浦長浜,87,295,147,148
2005,内浦,内浦三津,286,833,401,432
2005,西浦,西浦足保,29,106,49,57
2005,西浦,西浦江梨,82,266,131,135
2005,西浦,西浦河内,63,246,107,139
2005,西浦,西浦木負,122,423,205,218
2005,西浦,西浦久連,105,387,200,187
2005,西浦,西浦久料,30,98,45,53
2005,西浦,西浦古宇,158,293,127,166
2005,西浦,西浦立保,50,191,84,107
2005,西浦,西浦平沢,35,144,68,76
2005,原,植田,183,508,260,248
2005,原,原　新田,503,1326,680,646
2005,原,西添町,507,1380,718,662
2005,原,大塚,2190,5758,2824,2934
2005,原,原　西町,823,2182,1091,1091
2005,原,原　東町,1574,4206,2066,2140
2005,原,原町中一丁目,109,311,163,148
2005,原,原町中二丁目,169,492,253,239
2005,原,原町中三丁目,353,1045,489,556
2005,原,一本松,321,826,412,414
2005,原,原　一本松,30,61,33,28
2005,原,桃里,495,1361,693,668
2005,原,原　六軒町,589,1697,861,836
2005,浮島,根古屋,680,1935,966,969
2005,浮島,井出,520,1535,734,801
2005,浮島,平沼,506,1216,633,583
2005,浮島,石川,519,1533,763,770
2005,戸田,井田,37,91,43,48
2005,戸田,戸田　入浜,184,465,235,230
2005,戸田,戸田　上野,89,250,119,131
2005,戸田,戸田　大浦,86,235,119,116
2005,戸田,戸田　大上,51,166,88,78
2005,戸田,戸田　奥南,52,130,61,69
2005,戸田,戸田　大中島,243,607,304,303
2005,戸田,戸田　鬼川,125,338,162,176
2005,戸田,戸田　小山田,85,222,116,106
2005,戸田,戸田　口南,47,123,52,71
2005,戸田,戸田　小中島,102,245,117,128
2005,戸田,戸田　一色,100,289,146,143
2005,戸田,戸田　新田,31,68,38,30
2005,戸田,戸田　大門,68,210,109,101
2005,戸田,戸田　中上,62,167,85,82
2005,戸田,戸田　平戸,63,186,90,96
2005,戸田,戸田　舟山,36,82,44,38
2005,戸田,戸田　御浜,59,131,69,62
2004,第一,大手町一丁目,51,82,47,35
2004,第一,大手町二丁目,175,346,169,177
2004,第一,大手町三丁目,49,115,59,56
2004,第一,大手町四丁目,117,260,119,141
2004,第一,大手町五丁目,112,295,146,149
2004,第一,本字出口町,39,102,49,53
2004,第一,幸町,54,147,70,77
2004,第一,本白銀町,158,319,140,179
2004,第一,白銀町,113,248,115,133
2004,第一,末広町,294,768,352,416
2004,第一,仲町,26,74,34,40
2004,第一,浅間町,11,28,14,14
2004,第一,魚町,13,49,25,24
2004,第一,通横町,7,16,7,9
2004,第一,鵰町,9,26,12,14
2004,第一,新町,5,11,7,4
2004,第一,添地町,191,388,184,204
2004,第一,西条町,193,446,214,232
2004,第一,上土町,124,290,141,149
2004,第一,本字仲町,3,8,5,3
2004,第一,本字浅間町,22,56,27,29
2004,第一,本字新町,10,31,16,15
2004,第一,本錦町,261,571,267,304
2004,第一,本丸子町,111,280,136,144
2004,第一,錦町,55,127,60,67
2004,第一,丸子町,6,12,2,10
2004,第一,八幡町,163,353,162,191
2004,第一,本町,46,92,54,38
2004,第一,下本町,42,88,45,43
2004,第一,大門町,32,83,37,46
2004,第一,真砂町,432,1026,495,531
2004,第一,町方町,81,212,93,119
2004,第一,東宮後町,24,66,27,39
2004,第二,旭町,189,488,246,242
2004,第二,本字下小路町,90,215,98,117
2004,第二,本字宮町,92,238,119,119
2004,第二,市道町,357,858,392,466
2004,第二,春日町,85,214,115,99
2004,第二,蓼原町,66,216,105,111
2004,第二,蛇松町,85,220,107,113
2004,第二,本字下河原町,81,214,104,110
2004,第二,本字下河原街出口,77,203,101,102
2004,第二,下河原町,482,1213,578,635
2004,第二,本字下一丁田,162,362,162,200
2004,第二,本字前田,45,115,59,56
2004,第二,本字千本郷林,128,306,148,158
2004,第二,本字千本,84,204,99,105
2004,第二,本字千本,65,175,88,87
2004,第二,千本常盤町,73,147,67,80
2004,第二,常盤町一丁目,100,238,111,127
2004,第二,常盤町二丁目,45,113,54,59
2004,第二,常盤町三丁目,112,306,139,167
2004,第二,本松下,147,367,162,205
2004,第二,本西松下,74,194,96,98
2004,第二,本字松下七反田,91,211,107,104
2004,第二,松下町,15,37,22,15
2004,第二,千本緑町一丁目,100,228,95,133
2004,第二,千本緑町二丁目,42,97,43,54
2004,第二,千本緑町三丁目,63,141,67,74
2004,第二,千本港町,91,240,124,116
2004,第二,本字千本港町,1,1,0,1
2004,第二,千本東町,75,174,84,90
2004,第二,千本西町,134,305,154,151
2004,第二,千本中町,60,186,86,100
2004,第三,我入道秋葉町,193,543,267,276
2004,第三,我入道外新田,1,6,3,3
2004,第三,下香貫石原,152,429,217,212
2004,第三,下香貫藤井原,213,528,273,255
2004,第三,下香貫矢丸,76,190,97,93
2004,第三,我入道稲荷町,145,384,200,184
2004,第三,下香貫牛臥,327,835,404,431
2004,第三,下香貫山宮前,33,98,49,49
2004,第三,我入道江川,149,414,199,215
2004,第三,我入道南条寺,237,633,301,332
2004,第三,香貫が丘,77,285,145,140
2004,第三,下香貫木ノ宮,362,1016,492,524
2004,第三,下香貫前角,68,166,83,83
2004,第三,下香貫猪沼,93,144,47,97
2004,第三,下香貫塩場,161,410,211,199
2004,第三,下香貫前原,113,276,123,153
2004,第三,下香貫浜田,191,531,268,263
2004,第三,下香貫善太夫,179,497,232,265
2004,第三,下香貫上障子,162,384,179,205
2004,第三,下香貫下障子,385,944,455,489
2004,第三,善太夫西原,6,19,10,9
2004,第三,下香貫外原,58,159,72,87
2004,第三,我入道津島町,77,210,108,102
2004,第三,下香貫島郷,380,1010,502,508
2004,第三,下香貫塚田,174,464,235,229
2004,第三,下香貫大久保,245,687,322,365
2004,第三,下香貫柿原,179,450,221,229
2004,第三,下香貫清水,209,506,262,244
2004,第三,下香貫馬場,318,776,389,387
2004,第三,下香貫西村,136,320,159,161
2004,第三,下香貫上ノ原,125,340,160,180
2004,第三,下香貫給田,14,42,20,22
2004,第三,我入道浜町,115,314,150,164
2004,第三,我入道蔓陀ヶ原,42,95,45,50
2004,第三,我入道浜方,17,44,18,26
2004,第三,我入道林町,110,333,157,176
2004,第三,我入道東町,156,481,244,237
2004,第三,我入道一本松町,148,445,208,237
2004,第三,下香貫塩満,171,465,234,231
2004,第三,下香貫七面,77,223,122,101
2004,第三,下香貫林ノ下,206,595,305,290
2004,第三,下香貫汐入,218,503,259,244
2004,第三,下香貫樋ノ口,150,394,190,204
2004,第三,下香貫宮脇,379,1004,485,519
2004,第三,下香貫宮原,51,126,58,68
2004,第三,下香貫八重,469,1136,552,584
2004,第三,下香貫八重原,4,14,9,5
2004,第三,下香貫楊原,397,1052,507,545
2004,第三,下香貫六反,10,18,8,10
2004,第四,市場町,305,719,347,372
2004,第四,上香貫大洞,1,4,2,2
2004,第四,上香貫仰天峰,16,46,26,20
2004,第四,上香貫長洞,5,10,5,5
2004,第四,上香貫東坂,7,12,5,7
2004,第四,上香蔓陀ヶ原,1,3,2,1
2004,第四,黒瀬町,44,136,65,71
2004,第四,西島町,534,1342,649,693
2004,第四,住吉町,233,567,276,291
2004,第四,三園町,398,898,461,437
2004,第四,玉江町,212,540,268,272
2004,第四,中瀬町,374,826,398,428
2004,第四,中原町,67,180,88,92
2004,第四,上香貫三貫地,227,610,319,291
2004,第四,上香貫東本郷町,10,13,7,6
2004,第四,上香貫二瀬川町,134,355,179,176
2004,第四,上香貫宮原町,206,477,227,250
2004,第四,上香貫獅子路,12,26,14,12
2004,第四,上香貫槙島町,89,207,100,107
2004,第四,上香貫一ノ洞,2,5,3,2
2004,第四,上香貫三ノ洞,6,14,6,8
2004,第四,上香貫九十九洞,20,58,29,29
2004,第四,上香貫坂口,4,8,4,4
2004,第四,上香貫手城山,3,5,2,3
2004,第四,山ヶ下町,13,37,19,18
2004,第四,上香貫八重,20,49,23,26
2004,第四,上香貫鉛山,3,4,2,2
2004,第四,本郷町,722,1781,825,956
2004,第四,上香貫三園町,39,100,57,43
2004,第四,南本郷町,325,814,391,423
2004,第四,上香貫南本郷町,14,37,17,20
2004,第四,御幸町,484,1171,558,613
2004,第四,吉田町,942,2182,1039,1143
2004,第五,泉町,304,756,382,374
2004,第五,庄栄町,386,919,430,489
2004,第五,山王台,404,900,439,461
2004,第五,三枚橋町,256,572,280,292
2004,第五,杉崎町,370,920,441,479
2004,第五,新宿町,709,1600,763,837
2004,第五,三枚橋杉崎町,1,6,3,3
2004,第五,平町,468,978,499,479
2004,第五,高島町,566,1194,593,601
2004,第五,高沢町,817,1749,872,877
2004,第五,高島本町,389,831,422,409
2004,第五,本字下中溝,12,29,17,12
2004,第五,三枚橋荒田,25,68,36,32
2004,第五,三枚橋竹ノ岬,125,237,151,86
2004,第五,日の出町,309,816,397,419
2004,第五,三枚橋日ノ出町,70,175,81,94
2004,第五,富士見町,284,580,302,278
2004,第五,双葉町,263,554,267,287
2004,第五,本田町,561,1309,651,658
2004,第五,三芳町,95,230,97,133
2004,第五,米山町,389,988,470,518
2004,大平,大平,1556,4511,2171,2340
2004,片浜,今沢,2183,5090,2411,2679
2004,片浜,大諏訪,1122,3038,1543,1495
2004,片浜,北今沢,307,848,437,411
2004,片浜,小諏訪,1038,2789,1395,1394
2004,片浜,西間門二丁目,25,73,36,37
2004,片浜,西間門三丁目,17,49,24,25
2004,片浜,西間門,1256,3107,1544,1563
2004,片浜,東間門一丁目,11,29,11,18
2004,片浜,東間門二丁目,89,211,94,117
2004,片浜,東間門三丁目,59,160,79,81
2004,片浜,東間門,243,565,279,286
2004,片浜,松長,794,2156,1065,1091
2004,金岡,足高,568,1194,599,595
2004,金岡,共栄町,263,590,302,288
2004,金岡,江原町,456,1069,530,539
2004,金岡,神田町,470,1084,605,479
2004,金岡,北園町,79,209,106,103
2004,金岡,寿町,597,1320,663,657
2004,金岡,沢田,12,42,26,16
2004,金岡,沢田町,118,323,156,167
2004,金岡,岡一色,1201,3214,1625,1589
2004,金岡,北高島町,454,1014,508,506
2004,金岡,新沢田町,490,1118,572,546
2004,金岡,駿河台,371,920,473,447
2004,金岡,高尾台,213,547,284,263
2004,金岡,高砂町,308,822,424,398
2004,金岡,五月町,504,1175,600,575
2004,金岡,筒井町,138,349,166,183
2004,金岡,中沢田,565,1603,800,803
2004,金岡,西熊堂,390,1139,573,566
2004,金岡,西沢田,1348,3477,1762,1715
2004,金岡,沼北町一丁目,545,1222,643,579
2004,金岡,沼北町二丁目,313,787,396,391
2004,金岡,花園町,302,711,355,356
2004,金岡,東熊堂,558,1341,704,637
2004,金岡,東沢田,337,919,453,466
2004,金岡,宮前町,193,458,218,240
2004,金岡,松沢町,280,752,369,383
2004,金岡,緑ヶ丘,73,147,82,65
2004,金岡,岡宮,2023,5194,2644,2550
2004,金岡,柳町,501,1077,570,507
2004,金岡,豊町,297,855,425,430
2004,金岡,若葉町,581,1341,690,651
2004,大岡,大岡　石田ヶ丘,80,196,96,100
2004,大岡,大岡　駅前町,519,1250,618,632
2004,大岡,大岡　自由ヶ丘,461,956,439,517
2004,大岡,大岡　上石田,844,2114,1061,1053
2004,大岡,大岡　木瀬川,1322,3295,1675,1620
2004,大岡,大岡　平和郷,134,351,168,183
2004,大岡,大岡　北小林,406,1074,546,528
2004,大岡,小林台,112,305,153,152
2004,大岡,大岡　下石田,1733,4619,2253,2366
2004,大岡,大岡　仙岳町,110,286,152,134
2004,大岡,大岡　太田町,87,185,98,87
2004,大岡,大岡　高田,416,974,489,485
2004,大岡,大岡　竹ノ岬,71,180,87,93
2004,大岡,大岡　駅前町,82,227,121,106
2004,大岡,大岡　中石田,1205,2977,1523,1454
2004,大岡,大岡　富岳町,97,177,70,107
2004,大岡,大岡　富士町,117,263,142,121
2004,大岡,大岡　沼平町,282,710,335,375
2004,大岡,大岡　南小林,1162,2956,1473,1483
2004,大岡,大岡　柏葉尾,273,621,278,343
2004,大岡,大岡　日吉,1426,3718,1826,1892
2004,大岡,大岡　大岡団地,248,499,228,278
2004,静浦,江浦,334,957,450,507
2004,静浦,口野,246,725,349,376
2004,静浦,志下,1110,3080,1546,1534
2004,静浦,獅子浜,426,1243,606,637
2004,静浦,多比,248,845,417,428
2004,静浦,馬込,214,624,317,307
2004,愛鷹,青野,710,2156,1092,1064
2004,愛鷹,鳥谷,581,1680,869,811
2004,愛鷹,西椎路,1153,3173,1599,1574
2004,愛鷹,東原,878,2452,1217,1235
2004,愛鷹,東椎路,2393,6313,3124,3189
2004,愛鷹,宮本　富士通寮,33,33,33,0
2004,愛鷹,宮本,157,325,160,165
2004,愛鷹,柳沢,257,757,359,398
2004,内浦,内浦小海,111,371,194,177
2004,内浦,内浦重須,237,574,249,325
2004,内浦,内浦重寺,142,398,189,209
2004,内浦,内浦長浜,86,303,153,150
2004,内浦,内浦三津,282,841,400,441
2004,西浦,西浦足保,29,113,53,60
2004,西浦,西浦江梨,83,269,133,136
2004,西浦,西浦河内,66,248,109,139
2004,西浦,西浦木負,123,433,211,222
2004,西浦,西浦久連,106,400,203,197
2004,西浦,西浦久料,30,99,45,54
2004,西浦,西浦古宇,140,278,125,153
2004,西浦,西浦立保,50,192,86,106
2004,西浦,西浦平沢,35,149,70,79
2004,原,植田,182,506,260,246
2004,原,原　新田,501,1341,685,656
2004,原,西添町,516,1384,728,656
2004,原,大塚,2206,5896,2903,2993
2004,原,原　西町,814,2219,1110,1109
2004,原,原　東町,1544,4170,2051,2119
2004,原,原町中一丁目,109,310,166,144
2004,原,原町中二丁目,166,484,248,236
2004,原,原町中三丁目,344,1034,491,543
2004,原,一本松,310,840,423,417
2004,原,原　一本松,20,42,24,18
2004,原,桃里,491,1350,686,664
2004,原,原　六軒町,575,1643,828,815
2004,浮島,根古屋,690,1986,990,996
2004,浮島,井出,529,1555,745,810
2004,浮島,平沼,435,1170,625,545
2004,浮島,石川,535,1568,783,785